--- ATTENTION : CONSERVEZ CETTE LICENCE SI VOUS REDISTRIBUEZ CE FICHIER ---
License ABU
-=-=-=-=-=-
Version 1.1, Aout 1999

Copyright (C) 1999 Association de Bibliophiles Universels
   http://abu.cnam.fr/
   abu@cnam.fr

La base de textes de l'Association des Bibliophiles Universels (ABU)
est une oeuvre de compilation, elle peut être copiée, diffusée et
modifiée dans les conditions suivantes :

1.  Toute copie à des fins privées, à des fins d'illustration de l'enseignement
    ou de recherche scientifique est autorisée.

2.  Toute diffusion ou inclusion dans une autre oeuvre doit

     a) soit inclure la presente licence s'appliquant a l'ensemble de la
        diffusion ou de l'oeuvre dérivee.

     b) soit permettre aux bénéficiaires de cette diffusion ou de cette
        oeuvre dérivée d'en extraire facilement et gratuitement une version
        numérisée de chaque texte inclu, muni de la présente licence.  Cette
        possibilité doit être mentionnée explicitement et de façon claire,
        ainsi que le fait que la présente notice s'applique aux documents
        extraits.

     c) permettre aux bénéficiaires de cette diffusion ou de cette
        oeuvre dérivée d'en extraire facilement et gratuitement la version
        numérisée originale, munie le cas échéant des améliorations visées au
        paragraphe 6, si elles sont présentent dans la diffusion ou la nouvelle
        oeuvre. Cette possibilité doit être mentionnée explicitement et de
        façon claire, ainsi que le fait que la présente notice s'applique aux
        documents extraits.

   Dans tous les autres cas, la présente licence sera réputée s'appliquer
   à l'ensemble de la diffusion ou de l'oeuvre dérivée.


3. L'en-tête qui accompagne chaque fichier doit être intégralement 
   conservée au sein de la copie.

4. La mention du producteur original doit être conservée, ainsi
   que celle des contributeurs ultérieurs.

5. Toute modification ultérieure, par correction d'erreurs,
   additions de variantes, mise en forme dans un autre format, ou autre,
   doit être indiquée.  L'indication des diverses contributions devra être
   aussi précise que possible, et datée.

6. Ce copyright s'applique obligatoirement à toute amélioration
   par simple correction d'erreurs ou d'oublis mineurs (orthographe,
   phrase manquante, ...), c'est-à-dire ne correspondant pas à
   l'adjonction d'une autre variante connue du texte, qui devra donc
   comporter la présente notice.

----------------------- FIN DE LA LICENCE ABU --------------------------------

habanera	habanera	Nom:Fem+SG
habile	habile	Adj:InvGen+SG
habilement	habilement	Adv
habiles	habile	Adj:InvGen+PL
habileté	habileté	Nom:Fem+SG
habiletés	habileté	Nom:Fem+PL
habilita	habiliter	Ver:IPSim+SG+P3
habilitaient	habiliter	Ver:IImp+PL+P3
habilitai	habiliter	Ver:IPSim+SG+P1
habilitais	habiliter	Ver:IImp+SG+P1:IImp+SG+P2
habilitait	habiliter	Ver:IImp+SG+P3
habilitâmes	habiliter	Ver:IPSim+PL+P1
habilitant	habilitant	Adj:Mas+SG
habilitant	habiliter	Ver:PPre
habilitas	habiliter	Ver:IPSim+SG+P2
habilitasse	habiliter	Ver:SImp+SG+P1
habilitassent	habiliter	Ver:SImp+PL+P3
habilitasses	habiliter	Ver:SImp+SG+P2
habilitassiez	habiliter	Ver:SImp+PL+P2
habilitassions	habiliter	Ver:SImp+PL+P1
habilitâtes	habiliter	Ver:IPSim+PL+P2
habilitât	habiliter	Ver:SImp+SG+P3
habilitation	habilitation	Nom:Fem+SG
habilitations	habilitation	Nom:Fem+PL
habilitée	habilité	Adj:Fem+SG
habilitée	habiliter	Ver:PPas+Fem+SG
habilitées	habilité	Adj:Fem+PL
habilitées	habiliter	Ver:PPas+Fem+PL
habilité	habilité	Adj:Mas+SG
habilité	habilité	Nom:Fem+SG
habilite	habiliter	Ver:IPre+SG+P1:IPre+SG+P3:SPre+SG+P1:SPre+SG+P3:ImPre+SG+P2
habilité	habiliter	Ver:PPas+Mas+SG
habilitent	habiliter	Ver:IPre+PL+P3:SPre+PL+P3
habilitera	habiliter	Ver:IFut+SG+P3
habiliteraient	habiliter	Ver:CPre+PL+P3
habiliterai	habiliter	Ver:IFut+SG+P1
habiliterais	habiliter	Ver:CPre+SG+P1:CPre+SG+P2
habiliterait	habiliter	Ver:CPre+SG+P3
habiliteras	habiliter	Ver:IFut+SG+P2
habilitèrent	habiliter	Ver:IPSim+PL+P3
habiliterez	habiliter	Ver:IFut+PL+P2
habiliter	habiliter	Ver:Inf
habiliteriez	habiliter	Ver:CPre+PL+P2
habiliterions	habiliter	Ver:CPre+PL+P1
habiliterons	habiliter	Ver:IFut+PL+P1
habiliteront	habiliter	Ver:IFut+PL+P3
habilités	habilité	Adj:Mas+PL
habilités	habilité	Nom:Fem+PL
habilites	habiliter	Ver:IPre+SG+P2:SPre+SG+P2
habilités	habiliter	Ver:PPas+Mas+PL
habilitez	habiliter	Ver:IPre+PL+P2:ImPre+PL+P2
habilitiez	habiliter	Ver:IImp+PL+P2:SPre+PL+P2
habilitions	habiliter	Ver:IImp+PL+P1:SPre+PL+P1
habilitons	habiliter	Ver:IPre+PL+P1:ImPre+PL+P1
habillable	habillable	Adj:InvGen+SG
habillage	habillage	Nom:Mas+SG
habillages	habillage	Nom:Mas+PL
habilla	habiller	Ver:IPSim+SG+P3
habillaient	habiller	Ver:IImp+PL+P3
habillai	habiller	Ver:IPSim+SG+P1
habillais	habiller	Ver:IImp+SG+P1:IImp+SG+P2
habillait	habiller	Ver:IImp+SG+P3
habillâmes	habiller	Ver:IPSim+PL+P1
habillant	habiller	Ver:PPre
habillas	habiller	Ver:IPSim+SG+P2
habillasse	habiller	Ver:SImp+SG+P1
habillassent	habiller	Ver:SImp+PL+P3
habillasses	habiller	Ver:SImp+SG+P2
habillassiez	habiller	Ver:SImp+PL+P2
habillassions	habiller	Ver:SImp+PL+P1
habillâtes	habiller	Ver:IPSim+PL+P2
habillât	habiller	Ver:SImp+SG+P3
habillée	habillé	Adj:Fem+SG
habillée	habiller	Ver:PPas+Fem+SG
habillées	habillé	Adj:Fem+PL
habillées	habiller	Ver:PPas+Fem+PL
habillé	habillé	Adj:Mas+SG
habille	habiller	Ver:IPre+SG+P1:IPre+SG+P3:SPre+SG+P1:SPre+SG+P3:ImPre+SG+P2
habillé	habiller	Ver:PPas+Mas+SG
habillement	habillement	Nom:Mas+SG
habillements	habillement	Nom:Mas+PL
habillent	habiller	Ver:IPre+PL+P3:SPre+PL+P3
habillera	habiller	Ver:IFut+SG+P3
habilleraient	habiller	Ver:CPre+PL+P3
habillerai	habiller	Ver:IFut+SG+P1
habillerais	habiller	Ver:CPre+SG+P1:CPre+SG+P2
habillerait	habiller	Ver:CPre+SG+P3
habilleras	habiller	Ver:IFut+SG+P2
habillèrent	habiller	Ver:IPSim+PL+P3
habillerez	habiller	Ver:IFut+PL+P2
habiller	habiller	Ver:Inf
habilleriez	habiller	Ver:CPre+PL+P2
habillerions	habiller	Ver:CPre+PL+P1
habillerons	habiller	Ver:IFut+PL+P1
habilleront	habiller	Ver:IFut+PL+P3
habillés	habillé	Adj:Mas+PL
habilles	habiller	Ver:IPre+SG+P2:SPre+SG+P2
habillés	habiller	Ver:PPas+Mas+PL
habilleur	habilleur	Nom:Mas+SG
habilleuse	habilleur	Nom:Fem+SG
habilleuses	habilleur	Nom:Fem+PL
habillez	habiller	Ver:IPre+PL+P2:ImPre+PL+P2
habilliez	habiller	Ver:IImp+PL+P2:SPre+PL+P2
habillions	habiller	Ver:IImp+PL+P1:SPre+PL+P1
habillons	habiller	Ver:IPre+PL+P1:ImPre+PL+P1
habitabilité	habitabilité	Nom:Fem+SG
habitable	habitable	Adj:InvGen+SG
habitables	habitable	Adj:InvGen+PL
habitacle	habitacle	Nom:Mas+SG
habitacles	habitacle	Nom:Mas+PL
habita	habiter	Ver:IPSim+SG+P3
habitaient	habiter	Ver:IImp+PL+P3
habitai	habiter	Ver:IPSim+SG+P1
habitais	habiter	Ver:IImp+SG+P1:IImp+SG+P2
habitait	habiter	Ver:IImp+SG+P3
habitâmes	habiter	Ver:IPSim+PL+P1
habitante	habitant	Nom:Fem+SG
habitantes	habitant	Nom:Fem+PL
habitant	habitant	Nom:Mas+SG
habitant	habiter	Ver:PPre
habitants	habitant	Nom:Mas+PL
habitas	habiter	Ver:IPSim+SG+P2
habitasse	habiter	Ver:SImp+SG+P1
habitassent	habiter	Ver:SImp+PL+P3
habitasses	habiter	Ver:SImp+SG+P2
habitassiez	habiter	Ver:SImp+PL+P2
habitassions	habiter	Ver:SImp+PL+P1
habitâtes	habiter	Ver:IPSim+PL+P2
habitat	habitat	Nom:Mas+SG
habitât	habiter	Ver:SImp+SG+P3
habitation	habitation	Nom:Fem+SG
habitations	habitation	Nom:Fem+PL
habitats	habitat	Nom:Mas+PL
habitée	habité	Adj:Fem+SG
habitée	habiter	Ver:PPas+Fem+SG
habitées	habité	Adj:Fem+PL
habitées	habiter	Ver:PPas+Fem+PL
habité	habité	Adj:Mas+SG
habite	habiter	Ver:IPre+SG+P1:IPre+SG+P3:SPre+SG+P1:SPre+SG+P3:ImPre+SG+P2
habitent	habiter	Ver:IPre+PL+P3:SPre+PL+P3
habitera	habiter	Ver:IFut+SG+P3
habiteraient	habiter	Ver:CPre+PL+P3
habiterai	habiter	Ver:IFut+SG+P1
habiterais	habiter	Ver:CPre+SG+P1:CPre+SG+P2
habiterait	habiter	Ver:CPre+SG+P3
habiteras	habiter	Ver:IFut+SG+P2
habitèrent	habiter	Ver:IPSim+PL+P3
habiterez	habiter	Ver:IFut+PL+P2
habiter	habiter	Ver:Inf
habiteriez	habiter	Ver:CPre+PL+P2
habiterions	habiter	Ver:CPre+PL+P1
habiterons	habiter	Ver:IFut+PL+P1
habiteront	habiter	Ver:IFut+PL+P3
habités	habité	Adj:Mas+PL
habites	habiter	Ver:IPre+SG+P2:SPre+SG+P2
habités	habiter	Ver:PPas+Mas+PL
habitez	habiter	Ver:IPre+PL+P2:ImPre+PL+P2
habit	habit	Nom:Mas+SG
habitiez	habiter	Ver:IImp+PL+P2:SPre+PL+P2
habitions	habiter	Ver:IImp+PL+P1:SPre+PL+P1
habitons	habiter	Ver:IPre+PL+P1:ImPre+PL+P1
habits	habit	Nom:Mas+PL
habits	habits	Nom:Mas+PL
habitua	habituer	Ver:IPSim+SG+P3
habituaient	habituer	Ver:IImp+PL+P3
habituai	habituer	Ver:IPSim+SG+P1
habituais	habituer	Ver:IImp+SG+P1:IImp+SG+P2
habituait	habituer	Ver:IImp+SG+P3
habituâmes	habituer	Ver:IPSim+PL+P1
habituant	habituer	Ver:PPre
habituas	habituer	Ver:IPSim+SG+P2
habituasse	habituer	Ver:SImp+SG+P1
habituassent	habituer	Ver:SImp+PL+P3
habituasses	habituer	Ver:SImp+SG+P2
habituassiez	habituer	Ver:SImp+PL+P2
habituassions	habituer	Ver:SImp+PL+P1
habituâtes	habituer	Ver:IPSim+PL+P2
habituât	habituer	Ver:SImp+SG+P3
habituation	habituation	Nom:Fem+SG
habituations	habituation	Nom:Fem+PL
habitude	habitude	Nom:Fem+SG
habitudes	habitude	Nom:Fem+PL
habitudes	habitudes	Nom:Fem+PL
habituée	habitué	Adj:Fem+SG
habituée	habitué	Nom:Fem+SG
habituée	habituer	Ver:PPas+Fem+SG
habituées	habitué	Adj:Fem+PL
habituées	habitué	Nom:Fem+PL
habituées	habituer	Ver:PPas+Fem+PL
habitué	habitué	Adj:Mas+SG
habitué	habitué	Nom:Mas+SG
habitue	habituer	Ver:IPre+SG+P1:IPre+SG+P3:SPre+SG+P1:SPre+SG+P3:ImPre+SG+P2
habitué	habituer	Ver:PPas+Mas+SG
habituel	habituel	Adj:Mas+SG
habituel	habituel	Nom:Mas+SG
habituelle	habituel	Adj:Fem+SG
habituellement	habituellement	Adv
habituelles	habituel	Adj:Fem+PL
habituels	habituel	Adj:Mas+PL
habituels	habituel	Nom:Mas+PL
habituent	habituer	Ver:IPre+PL+P3:SPre+PL+P3
habituera	habituer	Ver:IFut+SG+P3
habitueraient	habituer	Ver:CPre+PL+P3
habituerai	habituer	Ver:IFut+SG+P1
habituerais	habituer	Ver:CPre+SG+P1:CPre+SG+P2
habituerait	habituer	Ver:CPre+SG+P3
habitueras	habituer	Ver:IFut+SG+P2
habituèrent	habituer	Ver:IPSim+PL+P3
habituerez	habituer	Ver:IFut+PL+P2
habituer	habituer	Ver:Inf
habitueriez	habituer	Ver:CPre+PL+P2
habituerions	habituer	Ver:CPre+PL+P1
habituerons	habituer	Ver:IFut+PL+P1
habitueront	habituer	Ver:IFut+PL+P3
habitués	habitué	Adj:Mas+PL
habitués	habitué	Nom:Mas+PL
habitues	habituer	Ver:IPre+SG+P2:SPre+SG+P2
habitués	habituer	Ver:PPas+Mas+PL
habituez	habituer	Ver:IPre+PL+P2:ImPre+PL+P2
habituiez	habituer	Ver:IImp+PL+P2:SPre+PL+P2
habituions	habituer	Ver:IImp+PL+P1:SPre+PL+P1
habituons	habituer	Ver:IPre+PL+P1:ImPre+PL+P1
habitus	habitus	Nom:Mas+InvPL
hâblerie	hâblerie	Nom:Fem+SG
hâbleries	hâblerie	Nom:Fem+PL
hâbleur	hâbleur	Adj:Mas+SG
hâbleurs	hâbleur	Adj:Mas+PL
hâbleuse	hâbleur	Adj:Fem+SG
hâbleuse	hâbleur	Nom:Fem+SG
hâbleuses	hâbleur	Adj:Fem+PL
hâbleuses	hâbleur	Nom:Fem+PL
hachage	hachage	Nom:Mas+SG
hachages	hachage	Nom:Mas+PL
hacha	hacher	Ver:IPSim+SG+P3
hachaient	hacher	Ver:IImp+PL+P3
hachai	hacher	Ver:IPSim+SG+P1
hachais	hacher	Ver:IImp+SG+P1:IImp+SG+P2
hachait	hacher	Ver:IImp+SG+P3
hachâmes	hacher	Ver:IPSim+PL+P1
hachant	hacher	Ver:PPre
hachas	hacher	Ver:IPSim+SG+P2
hachasse	hacher	Ver:SImp+SG+P1
hachassent	hacher	Ver:SImp+PL+P3
hachasses	hacher	Ver:SImp+SG+P2
hachassiez	hacher	Ver:SImp+PL+P2
hachassions	hacher	Ver:SImp+PL+P1
hachâtes	hacher	Ver:IPSim+PL+P2
hachât	hacher	Ver:SImp+SG+P3
hachée	haché	Adj:Fem+SG
hachée	hacher	Ver:PPas+Fem+SG
hachées	haché	Adj:Fem+PL
hachées	hacher	Ver:PPas+Fem+PL
haché	haché	Adj:Mas+SG
hache	hache	Nom:Fem+SG
hache	hacher	Ver:IPre+SG+P1:IPre+SG+P3:SPre+SG+P1:SPre+SG+P3:ImPre+SG+P2
hachement	hachement	Nom:Mas+SG
hachent	hacher	Ver:IPre+PL+P3:SPre+PL+P3
hachera	hacher	Ver:IFut+SG+P3
hacheraient	hacher	Ver:CPre+PL+P3
hacherai	hacher	Ver:IFut+SG+P1
hacherais	hacher	Ver:CPre+SG+P1:CPre+SG+P2
hacherait	hacher	Ver:CPre+SG+P3
hacheras	hacher	Ver:IFut+SG+P2
hachereau	hachereau	Nom:Mas+SG
hachereaux	hachereau	Nom:Mas+PL
hachèrent	hacher	Ver:IPSim+PL+P3
hacherez	hacher	Ver:IFut+PL+P2
hacher	hacher	Ver:Inf
hacheriez	hacher	Ver:CPre+PL+P2
hacherions	hacher	Ver:CPre+PL+P1
hacherons	hacheron	Nom:Mas+PL
hacherons	hacher	Ver:IFut+PL+P1
hacheront	hacher	Ver:IFut+PL+P3
hachés	haché	Adj:Mas+PL
haches	hache	Nom:Fem+PL
haches	hacher	Ver:IPre+SG+P2:SPre+SG+P2
hachette	hachette	Nom:Fem+SG
hachettes	hachette	Nom:Fem+PL
hacheur	hacheur	Nom:Mas+SG
hacheurs	hacheur	Nom:Mas+PL
hachez	hacher	Ver:IPre+PL+P2:ImPre+PL+P2
hache-légumes	hache-légumes	Nom:Mas+InvPL
hache-paille	hache-paille	Nom:Mas+InvPL
hache-viande	hache-viande	Nom:Mas+InvPL
hachiez	hacher	Ver:IImp+PL+P2:SPre+PL+P2
hachions	hacher	Ver:IImp+PL+P1:SPre+PL+P1
hachisch	hachisch	Nom:Mas+InvPL
hachis	hachis	Nom:Mas+InvPL
hachoir	hachoir	Nom:Mas+SG
hachoirs	hachoir	Nom:Mas+PL
hachons	hacher	Ver:IPre+PL+P1:ImPre+PL+P1
hachura	hachurer	Ver:IPSim+SG+P3
hachuraient	hachurer	Ver:IImp+PL+P3
hachurai	hachurer	Ver:IPSim+SG+P1
hachurais	hachurer	Ver:IImp+SG+P1:IImp+SG+P2
hachurait	hachurer	Ver:IImp+SG+P3
hachurâmes	hachurer	Ver:IPSim+PL+P1
hachurant	hachurer	Ver:PPre
hachuras	hachurer	Ver:IPSim+SG+P2
hachurasse	hachurer	Ver:SImp+SG+P1
hachurassent	hachurer	Ver:SImp+PL+P3
hachurasses	hachurer	Ver:SImp+SG+P2
hachurassiez	hachurer	Ver:SImp+PL+P2
hachurassions	hachurer	Ver:SImp+PL+P1
hachurâtes	hachurer	Ver:IPSim+PL+P2
hachurât	hachurer	Ver:SImp+SG+P3
hachurée	hachuré	Adj:Fem+SG
hachurée	hachurer	Ver:PPas+Fem+SG
hachurées	hachuré	Adj:Fem+PL
hachurées	hachurer	Ver:PPas+Fem+PL
hachuré	hachuré	Adj:Mas+SG
hachure	hachure	Nom:Fem+SG
hachure	hachurer	Ver:IPre+SG+P1:IPre+SG+P3:SPre+SG+P1:SPre+SG+P3:ImPre+SG+P2
hachuré	hachurer	Ver:PPas+Mas+SG
hachurent	hachurer	Ver:IPre+PL+P3:SPre+PL+P3
hachurera	hachurer	Ver:IFut+SG+P3
hachureraient	hachurer	Ver:CPre+PL+P3
hachurerai	hachurer	Ver:IFut+SG+P1
hachurerais	hachurer	Ver:CPre+SG+P1:CPre+SG+P2
hachurerait	hachurer	Ver:CPre+SG+P3
hachureras	hachurer	Ver:IFut+SG+P2
hachurèrent	hachurer	Ver:IPSim+PL+P3
hachurerez	hachurer	Ver:IFut+PL+P2
hachurer	hachurer	Ver:Inf
hachureriez	hachurer	Ver:CPre+PL+P2
hachurerions	hachurer	Ver:CPre+PL+P1
hachurerons	hachurer	Ver:IFut+PL+P1
hachureront	hachurer	Ver:IFut+PL+P3
hachurés	hachuré	Adj:Mas+PL
hachures	hachure	Nom:Fem+PL
hachures	hachurer	Ver:IPre+SG+P2:SPre+SG+P2
hachurés	hachurer	Ver:PPas+Mas+PL
hachurez	hachurer	Ver:IPre+PL+P2:ImPre+PL+P2
hachuriez	hachurer	Ver:IImp+PL+P2:SPre+PL+P2
hachurions	hachurer	Ver:IImp+PL+P1:SPre+PL+P1
hachurons	hachurer	Ver:IPre+PL+P1:ImPre+PL+P1
hacienda	hacienda	Nom:Fem+SG
hacquebute	hacquebute	Nom:Fem+SG
hadale	hadal	Adj:Fem+SG
hadales	hadal	Adj:Fem+PL
hadal	hadal	Adj:Mas+SG
hadaux	hadal	Adj:Mas+PL
haddock	haddock	Nom:Mas+SG
hadith	hadith	Nom:Mas+SG
hadj	hadj	Nom:Mas+SG
hadji	hadji	Nom:Mas+SG
hadron	hadron	Nom:Mas+SG
hafnium	hafnium	Nom:Mas+SG
hagarde	hagard	Adj:Fem+SG
hagardes	hagard	Adj:Fem+PL
hagard	hagard	Adj:Mas+SG
hagards	hagard	Adj:Mas+PL
haggis	haggis	Nom:Mas+InvPL
hagiographe	hagiographe	Adj:InvGen+SG
hagiographe	hagiographe	Nom:InvGen+SG
hagiographie	hagiographie	Nom:Fem+SG
hagiographique	hagiographique	Adj:InvGen+SG
hagiologie	hagiologie	Nom:Fem+SG
ha	ha	Int
hahnium	hahnium	Nom:Mas+SG
haie	haie	Nom:Fem+SG
haïe	haïr	Ver:PPas+Fem+SG
haies	haie	Nom:Fem+PL
haïes	haïr	Ver:PPas+Fem+PL
haï	haïr	Ver:PPas+Mas+SG
haïkaï	haïkaï	Nom:Mas+SG
haïk	haïk	Nom:Mas+SG
haïku	haïku	Nom:Mas+InvPL
haillon	haillon	Nom:Mas+SG
haillonneuse	haillonneux	Adj:Fem+SG
haillonneuses	haillonneux	Adj:Fem+PL
haillonneux	haillonneux	Adj:Mas+InvPL
haillons	haillon	Nom:Mas+PL
haïmes	haïr	Ver:IPSim+PL+P1
haine	haine	Nom:Fem+SG
haines	haine	Nom:Fem+PL
haineuse	haineux	Adj:Fem+SG
haineuse	haineux	Nom:Fem+SG
haineusement	haineusement	Adv
haineuses	haineux	Adj:Fem+PL
haineuses	haineux	Nom:Fem+PL
haineux	haineux	Adj:Mas+InvPL
haineux	haineux	Nom:Mas+InvPL
hainuyère	hainuyer	Adj:Fem+SG
hainuyère	hainuyer	Nom:Fem+SG
hainuyer	hainuyer	Adj:Mas+SG
hainuyer	hainuyer	Nom:Mas+SG
haïra	haïr	Ver:IFut+SG+P3
haïraient	haïr	Ver:CPre+PL+P3
haïrai	haïr	Ver:IFut+SG+P1
haïrais	haïr	Ver:CPre+SG+P1:CPre+SG+P2
haïrait	haïr	Ver:CPre+SG+P3
haïras	haïr	Ver:IFut+SG+P2
haire	haire	Nom:Fem+SG
haïrent	haïr	Ver:IPSim+PL+P3
haïrez	haïr	Ver:IFut+PL+P2
haïr	haïr	Ver:Inf
haïriez	haïr	Ver:CPre+PL+P2
haïrions	haïr	Ver:CPre+PL+P1
haïrons	haïr	Ver:IFut+PL+P1
haïront	haïr	Ver:IFut+PL+P3
hais	haïr	Ver:IPre+SG+P1:IPre+SG+P2:ImPre+SG+P2
haïs	haïr	Ver:PPas+Mas+PL:IPSim+SG+P1:IPSim+SG+P2
haïssable	haïssable	Adj:InvGen+SG
haïssables	haïssable	Adj:InvGen+PL
haïssaient	haïr	Ver:IImp+PL+P3
haïssais	haïr	Ver:IImp+SG+P1:IImp+SG+P2
haïssait	haïr	Ver:IImp+SG+P3
haïssant	haïr	Ver:PPre
haïsse	haïr	Ver:SPre+SG+P1:SPre+SG+P3:SImp+SG+P1
haïssent	haïr	Ver:IPre+PL+P3:SPre+PL+P3:SImp+PL+P3
haïsses	haïr	Ver:SPre+SG+P2:SImp+SG+P2
haïssez	haïr	Ver:IPre+PL+P2:ImPre+PL+P2
haïssiez	haïr	Ver:IImp+PL+P2:SPre+PL+P2:SImp+PL+P2
haïssions	haïr	Ver:IImp+PL+P1:SPre+PL+P1:SImp+PL+P1
haïssons	haïr	Ver:IPre+PL+P1:ImPre+PL+P1
haïtes	haïr	Ver:IPSim+PL+P2
hait	haïr	Ver:IPre+SG+P3
haït	haïr	Ver:IPSim+SG+P3:SImp+SG+P3
haïtien	haïtien	Adj:Mas+SG
haïtien	haïtien	Nom:Mas+SG
haïtienne	haïtien	Adj:Fem+SG
haïtienne	haïtien	Nom:Fem+SG
haïtiennes	haïtien	Adj:Fem+PL
haïtiennes	haïtien	Nom:Fem+PL
hakka	hakka	Nom:Mas+SG
halage	halage	Nom:Mas+SG
halages	halage	Nom:Mas+PL
hala	haler	Ver:IPSim+SG+P3
hâla	hâler	Ver:IPSim+SG+P3
halaient	haler	Ver:IImp+PL+P3
hâlaient	hâler	Ver:IImp+PL+P3
halai	haler	Ver:IPSim+SG+P1
hâlai	hâler	Ver:IPSim+SG+P1
halais	haler	Ver:IImp+SG+P1:IImp+SG+P2
hâlais	hâler	Ver:IImp+SG+P1:IImp+SG+P2
halait	haler	Ver:IImp+SG+P3
hâlait	hâler	Ver:IImp+SG+P3
halâmes	haler	Ver:IPSim+PL+P1
hâlâmes	hâler	Ver:IPSim+PL+P1
halant	haler	Ver:PPre
hâlant	hâler	Ver:PPre
halas	haler	Ver:IPSim+SG+P2
hâlas	hâler	Ver:IPSim+SG+P2
halasse	haler	Ver:SImp+SG+P1
hâlasse	hâler	Ver:SImp+SG+P1
halassent	haler	Ver:SImp+PL+P3
hâlassent	hâler	Ver:SImp+PL+P3
halasses	haler	Ver:SImp+SG+P2
hâlasses	hâler	Ver:SImp+SG+P2
halassiez	haler	Ver:SImp+PL+P2
hâlassiez	hâler	Ver:SImp+PL+P2
halassions	haler	Ver:SImp+PL+P1
hâlassions	hâler	Ver:SImp+PL+P1
halâtes	haler	Ver:IPSim+PL+P2
hâlâtes	hâler	Ver:IPSim+PL+P2
halât	haler	Ver:SImp+SG+P3
hâlât	hâler	Ver:SImp+SG+P3
halbi	halbi	Nom:Mas+SG
halbran	halbran	Nom:Mas+SG
halbrenée	halbrené	Adj:Fem+SG
halbrenée	halbrener	Ver:PPas+Fem+SG
halbrenées	halbrené	Adj:Fem+PL
halbrenées	halbrener	Ver:PPas+Fem+PL
halbrené	halbrené	Adj:Mas+SG
halbrené	halbrener	Ver:PPas+Mas+SG
halecret	halecret	Nom:Mas+SG
hâlée	hâlé	Adj:Fem+SG
halée	haler	Ver:PPas+Fem+SG
hâlée	hâler	Ver:PPas+Fem+SG
hâlées	hâlé	Adj:Fem+PL
halées	haler	Ver:PPas+Fem+PL
hâlées	hâler	Ver:PPas+Fem+PL
hâlé	hâlé	Adj:Mas+SG
hâle	hâle	Nom:Mas+SG
hale	haler	Ver:IPre+SG+P1:IPre+SG+P3:SPre+SG+P1:SPre+SG+P3:ImPre+SG+P2
hâle	hâler	Ver:IPre+SG+P1:IPre+SG+P3:SPre+SG+P1:SPre+SG+P3:ImPre+SG+P2
halé	haler	Ver:PPas+Mas+SG
hâlé	hâler	Ver:PPas+Mas+SG
haleine	haleine	Nom:Fem+SG
haleine	haleiner	Ver:IPre+SG+P1:IPre+SG+P3:SPre+SG+P1:SPre+SG+P3:ImPre+SG+P2
haleines	haleine	Nom:Fem+PL
haleines	haleiner	Ver:IPre+SG+P2:SPre+SG+P2
halène	halener	Ver:IPre+SG+P1:IPre+SG+P3:SPre+SG+P1:SPre+SG+P3:ImPre+SG+P2
halènent	halener	Ver:IPre+PL+P3:SPre+PL+P3
halènera	halener	Ver:IFut+SG+P3
halèneraient	halener	Ver:CPre+PL+P3
halènerai	halener	Ver:IFut+SG+P1
halènerais	halener	Ver:CPre+SG+P1:CPre+SG+P2
halènerait	halener	Ver:CPre+SG+P3
halèneras	halener	Ver:IFut+SG+P2
halènerez	halener	Ver:IFut+PL+P2
halener	halener	Ver:Inf
halèneriez	halener	Ver:CPre+PL+P2
halènerions	halener	Ver:CPre+PL+P1
halènerons	halener	Ver:IFut+PL+P1
halèneront	halener	Ver:IFut+PL+P3
halènes	halener	Ver:IPre+SG+P2:SPre+SG+P2
halent	haler	Ver:IPre+PL+P3:SPre+PL+P3
hâlent	hâler	Ver:IPre+PL+P3:SPre+PL+P3
hâlera	hâler	Ver:IFut+SG+P3
hâleraient	hâler	Ver:CPre+PL+P3
hâlerai	hâler	Ver:IFut+SG+P1
hâlerais	hâler	Ver:CPre+SG+P1:CPre+SG+P2
hâlerait	hâler	Ver:CPre+SG+P3
hâleras	hâler	Ver:IFut+SG+P2
halèrent	haler	Ver:IPSim+PL+P3
hâlèrent	hâler	Ver:IPSim+PL+P3
hâlerez	hâler	Ver:IFut+PL+P2
haler	haler	Nom:Mas+SG
haler	haler	Ver:Inf
hâler	hâler	Ver:Inf
hâleriez	hâler	Ver:CPre+PL+P2
hâlerions	hâler	Ver:CPre+PL+P1
hâlerons	hâler	Ver:IFut+PL+P1
hâleront	hâler	Ver:IFut+PL+P3
hâlés	hâlé	Adj:Mas+PL
hâles	hâle	Nom:Mas+PL
hales	haler	Ver:IPre+SG+P2:SPre+SG+P2
hâles	hâler	Ver:IPre+SG+P2:SPre+SG+P2
halés	haler	Ver:PPas+Mas+PL
hâlés	hâler	Ver:PPas+Mas+PL
haleta	haleter	Ver:IPSim+SG+P3
haletaient	haleter	Ver:IImp+PL+P3
haletai	haleter	Ver:IPSim+SG+P1
haletais	haleter	Ver:IImp+SG+P1:IImp+SG+P2
haletait	haleter	Ver:IImp+SG+P3
haletâmes	haleter	Ver:IPSim+PL+P1
haletante	haletant	Adj:Fem+SG
haletantes	haletant	Adj:Fem+PL
haletant	haletant	Adj:Mas+SG
haletant	haleter	Ver:PPre
haletants	haletant	Adj:Mas+PL
haletas	haleter	Ver:IPSim+SG+P2
haletasse	haleter	Ver:SImp+SG+P1
haletassent	haleter	Ver:SImp+PL+P3
haletasses	haleter	Ver:SImp+SG+P2
haletassiez	haleter	Ver:SImp+PL+P2
haletassions	haleter	Ver:SImp+PL+P1
haletâtes	haleter	Ver:IPSim+PL+P2
haletât	haleter	Ver:SImp+SG+P3
halète	haleter	Ver:IPre+SG+P1:IPre+SG+P3:SPre+SG+P1:SPre+SG+P3:ImPre+SG+P2
haleté	haleter	Ver:PPas+Mas+SG
halètement	halètement	Nom:Mas+SG
halètements	halètement	Nom:Mas+PL
halètent	haleter	Ver:IPre+PL+P3:SPre+PL+P3
halètera	haleter	Ver:IFut+SG+P3
halèteraient	haleter	Ver:CPre+PL+P3
halèterai	haleter	Ver:IFut+SG+P1
halèterais	haleter	Ver:CPre+SG+P1:CPre+SG+P2
halèterait	haleter	Ver:CPre+SG+P3
halèteras	haleter	Ver:IFut+SG+P2
haletèrent	haleter	Ver:IPSim+PL+P3
halèterez	haleter	Ver:IFut+PL+P2
haleter	haleter	Ver:Inf
halèteriez	haleter	Ver:CPre+PL+P2
halèterions	haleter	Ver:CPre+PL+P1
halèterons	haleter	Ver:IFut+PL+P1
halèteront	haleter	Ver:IFut+PL+P3
halètes	haleter	Ver:IPre+SG+P2:SPre+SG+P2
haletez	haleter	Ver:IPre+PL+P2:ImPre+PL+P2
haletiez	haleter	Ver:IImp+PL+P2:SPre+PL+P2
haletions	haleter	Ver:IImp+PL+P1:SPre+PL+P1
haletons	haleter	Ver:IPre+PL+P1:ImPre+PL+P1
haleur	haleur	Nom:Mas+SG
haleuse	haleur	Nom:Fem+SG
halez	haler	Ver:IPre+PL+P2:ImPre+PL+P2
hâlez	hâler	Ver:IPre+PL+P2:ImPre+PL+P2
half-track	half-track	Nom:Mas+SG
halicte	halicte	Nom:Mas+SG
halieutique	halieutique	Adj:InvGen+SG
halieutique	halieutique	Nom:Fem+SG
haliez	haler	Ver:IImp+PL+P2:SPre+PL+P2
hâliez	hâler	Ver:IImp+PL+P2:SPre+PL+P2
halions	haler	Ver:IImp+PL+P1:SPre+PL+P1
hâlions	hâler	Ver:IImp+PL+P1:SPre+PL+P1
haliotide	haliotide	Nom:Fem+SG
haliple	haliple	Nom:Mas+SG
halite	halite	Nom:Fem+SG
halitueux	halitueux	Adj:Mas+InvPL
hallage	hallage	Nom:Mas+SG
hallali	hallali	Int
hallali	hallali	Nom:Mas+SG
hallebarde	hallebarde	Nom:Fem+SG
hallebardes	hallebarde	Nom:Fem+PL
hallebardier	hallebardier	Nom:Mas+SG
halle	halle	Nom:Fem+SG
halles	halle	Nom:Fem+PL
halles	halles	Nom:Fem+PL
hall	hall	Nom:Mas+SG
hallier	hallier	Nom:Mas+SG
halloween	halloween	Nom:Fem+SG
halls	hall	Nom:Mas+PL
hallstattien	hallstattien	Adj:Mas+SG
hallstattienne	hallstattien	Adj:Fem+SG
hallstattiennes	hallstattien	Adj:Fem+PL
hallucinante	hallucinant	Adj:Fem+SG
hallucinantes	hallucinant	Adj:Fem+PL
hallucinant	hallucinant	Adj:Mas+SG
hallucinant	halluciner	Ver:PPre
hallucinants	hallucinant	Adj:Mas+PL
hallucination	hallucination	Nom:Fem+SG
hallucinations	hallucination	Nom:Fem+PL
hallucinatoire	hallucinatoire	Adj:InvGen+SG
hallucinatoires	hallucinatoire	Adj:InvGen+PL
hallucinée	halluciné	Adj:Fem+SG
hallucinée	halluciné	Nom:Fem+SG
hallucinée	halluciner	Ver:PPas+Fem+SG
hallucinées	halluciné	Adj:Fem+PL
hallucinées	halluciné	Nom:Fem+PL
hallucinées	halluciner	Ver:PPas+Fem+PL
halluciné	halluciné	Adj:Mas+SG
halluciné	halluciné	Nom:Mas+SG
hallucine	halluciner	Ver:Imp+SG+P2
hallucine	halluciner	Ver:IPre+SG+P1
hallucine	halluciner	Ver:IPre+SG+P3
halluciné	halluciner	Ver:PPas+Mas+SG
hallucine	halluciner	Ver:SPre+SG+P1
hallucine	halluciner	Ver:SPre+SG+P3
halluciner	halluciner	Ver:Inf
hallucinés	halluciné	Adj:Mas+PL
hallucinés	halluciné	Nom:Mas+PL
hallucinés	halluciner	Ver:PPas+Mas+PL
hallucinogène	hallucinogène	Adj:InvGen+SG
hallucinogène	hallucinogène	Nom:Mas+SG
hallucinogènes	hallucinogène	Adj:InvGen+PL
hallucinogènes	hallucinogène	Nom:Mas+PL
hallucinose	hallucinose	Nom:Fem+SG
halogénation	halogénation	Nom:Fem+SG
halogène	halogène	Adj:InvGen+SG
halogéné	halogéné	Adj:Mas+SG
halogène	halogène	Nom:Mas+SG
halogène	halogéner	Ver:IPre+SG+P1:IPre+SG+P3:SPre+SG+P1:SPre+SG+P3:ImPre+SG+P2
halogènes	halogène	Adj:InvGen+PL
halogènes	halogène	Nom:Mas+PL
halogènes	halogéner	Ver:IPre+SG+P2:SPre+SG+P2
halogénure	halogénure	Nom:Mas+SG
halographie	halographie	Nom:Fem+SG
halo	halo	Nom:Mas+SG
hâloir	hâloir	Nom:Mas+SG
halons	haler	Ver:IPre+PL+P1:ImPre+PL+P1
hâlons	hâler	Ver:IPre+PL+P1:ImPre+PL+P1
halons	halon	Nom:Mas+PL
halopéridol	halopéridol	Nom:Mas+SG
halophile	halophile	Adj:InvGen+SG
halophyte	halophyte	Adj:InvGen+SG
halos	halo	Nom:Mas+PL
halothane	halothane	Nom:Mas+SG
halte	halte	Int
halte	halte	Nom:Fem+SG
halte	halter	Ver:IPre+SG+P1:IPre+SG+P3:SPre+SG+P1:SPre+SG+P3:ImPre+SG+P2
haltère	haltère	Nom:Mas+SG
haltères	haltère	Nom:Mas+PL
haltères	haltères	Nom:Mas+PL
haltérophile	haltérophile	Adj:InvGen+SG
haltérophile	haltérophile	Nom:InvGen+SG
haltérophiles	haltérophile	Adj:InvGen+PL
haltérophiles	haltérophile	Nom:InvGen+PL
haltérophilie	haltérophilie	Nom:Fem+SG
haltes	halte	Nom:Fem+PL
haltes	halter	Ver:IPre+SG+P2:SPre+SG+P2
haltes-garderies	halte-garderie	Nom:Fem+PL
halte-garderie	halte-garderie	Nom:Fem+SG
halva	halva	Nom:Mas+SG
hamac	hamac	Nom:Mas+SG
hamacs	hamac	Nom:Mas+PL
hamada	hamada	Nom:Fem+SG
hamadryade	hamadryade	Nom:Fem+SG
hamadryas	hamadryas	Nom:Mas+InvPL
hamamélis	hamamélis	Nom:Mas+InvPL
hambourgeoise	hambourgeois	Adj:Fem+SG
hambourgeois	hambourgeois	Adj:Mas+InvPL
hamburger	hamburger	Nom:Mas+SG
hamburgers	hamburger	Nom:Mas+PL
hameau	hameau	Nom:Mas+SG
hameaux	hameau	Nom:Mas+PL
hameçon	hameçon	Nom:Mas+SG
hameçonnée	hameçonner	Ver:PPas+Fem+SG
hameçonne	hameçonner	Ver:Imp+SG+P2
hameçonne	hameçonner	Ver:IPre+SG+P1
hameçonne	hameçonner	Ver:IPre+SG+P3
hameçonne	hameçonner	Ver:SPre+SG+P1
hameçonne	hameçonner	Ver:SPre+SG+P3
hameçonnent	hameçonner	Ver:IPre+PL+P3
hameçonnent	hameçonner	Ver:SPre+PL+P3
hameçonner	hameçonner	Ver:Inf
hameçonnes	hameçonner	Ver:IPre+SG+P2
hameçonnes	hameçonner	Ver:SPre+SG+P2
hameçons	hameçon	Nom:Mas+PL
hamitique	hamitique	Adj:InvGen+SG
hamitiques	hamitique	Adj:InvGen+PL
hammam	hammam	Nom:Mas+SG
hammams	hammam	Nom:Mas+PL
hammerless	hammerless	Nom:Mas+InvPL
hampe	hampe	Nom:Fem+SG
hampes	hampe	Nom:Fem+PL
hamster	hamster	Nom:Mas+SG
hamsters	hamster	Nom:Mas+PL
hanafisme	hanafisme	Nom:Mas+SG
hanap	hanap	Nom:Mas+SG
hanbalisme	hanbalisme	Nom:Mas+SG
hancha	hancher	Ver:IPSim+SG+P3
hanchaient	hancher	Ver:IImp+PL+P3
hanchai	hancher	Ver:IPSim+SG+P1
hanchais	hancher	Ver:IImp+SG+P1:IImp+SG+P2
hanchait	hancher	Ver:IImp+SG+P3
hanchâmes	hancher	Ver:IPSim+PL+P1
hanchant	hancher	Ver:PPre
hanchas	hancher	Ver:IPSim+SG+P2
hanchasse	hancher	Ver:SImp+SG+P1
hanchassent	hancher	Ver:SImp+PL+P3
hanchasses	hancher	Ver:SImp+SG+P2
hanchassiez	hancher	Ver:SImp+PL+P2
hanchassions	hancher	Ver:SImp+PL+P1
hanchâtes	hancher	Ver:IPSim+PL+P2
hanchât	hancher	Ver:SImp+SG+P3
hanchée	hanché	Adj:Fem+SG
hanchée	hancher	Ver:PPas+Fem+SG
hanchées	hanché	Adj:Fem+PL
hanchées	hancher	Ver:PPas+Fem+PL
hanché	hanché	Adj:Mas+SG
hanche	hanche	Nom:Fem+SG
hanche	hancher	Ver:IPre+SG+P1:IPre+SG+P3:SPre+SG+P1:SPre+SG+P3:ImPre+SG+P2
hanché	hancher	Ver:PPas+Mas+SG
hanchement	hanchement	Nom:Mas+SG
hanchements	hanchement	Nom:Mas+PL
hanchent	hancher	Ver:IPre+PL+P3:SPre+PL+P3
hanchera	hancher	Ver:IFut+SG+P3
hancheraient	hancher	Ver:CPre+PL+P3
hancherai	hancher	Ver:IFut+SG+P1
hancherais	hancher	Ver:CPre+SG+P1:CPre+SG+P2
hancherait	hancher	Ver:CPre+SG+P3
hancheras	hancher	Ver:IFut+SG+P2
hanchèrent	hancher	Ver:IPSim+PL+P3
hancherez	hancher	Ver:IFut+PL+P2
hancher	hancher	Ver:Inf
hancheriez	hancher	Ver:CPre+PL+P2
hancherions	hancher	Ver:CPre+PL+P1
hancherons	hancher	Ver:IFut+PL+P1
hancheront	hancher	Ver:IFut+PL+P3
hanchés	hanché	Adj:Mas+PL
hanches	hanche	Nom:Fem+PL
hanches	hancher	Ver:IPre+SG+P2:SPre+SG+P2
hanchés	hancher	Ver:PPas+Mas+PL
hanchez	hancher	Ver:IPre+PL+P2:ImPre+PL+P2
hanchiez	hancher	Ver:IImp+PL+P2:SPre+PL+P2
hanchions	hancher	Ver:IImp+PL+P1:SPre+PL+P1
hanchons	hancher	Ver:IPre+PL+P1:ImPre+PL+P1
handballeur	handballeur	Nom:Mas+SG
handballeurs	handballeur	Nom:Mas+PL
handball	handball	Nom:Mas+SG
handicapa	handicaper	Ver:IPSim+SG+P3
handicapaient	handicaper	Ver:IImp+PL+P3
handicapai	handicaper	Ver:IPSim+SG+P1
handicapais	handicaper	Ver:IImp+SG+P1:IImp+SG+P2
handicapait	handicaper	Ver:IImp+SG+P3
handicapâmes	handicaper	Ver:IPSim+PL+P1
handicapant	handicaper	Ver:PPre
handicapas	handicaper	Ver:IPSim+SG+P2
handicapasse	handicaper	Ver:SImp+SG+P1
handicapassent	handicaper	Ver:SImp+PL+P3
handicapasses	handicaper	Ver:SImp+SG+P2
handicapassiez	handicaper	Ver:SImp+PL+P2
handicapassions	handicaper	Ver:SImp+PL+P1
handicapâtes	handicaper	Ver:IPSim+PL+P2
handicapât	handicaper	Ver:SImp+SG+P3
handicapée	handicapé	Adj:Fem+SG
handicapée	handicapé	Nom:Fem+SG
handicapée	handicaper	Ver:PPas+Fem+SG
handicapées	handicapé	Adj:Fem+PL
handicapées	handicapé	Nom:Fem+PL
handicapées	handicaper	Ver:PPas+Fem+PL
handicapé	handicapé	Adj:Mas+SG
handicapé	handicapé	Nom:Mas+SG
handicape	handicaper	Ver:IPre+SG+P1:IPre+SG+P3:SPre+SG+P1:SPre+SG+P3:ImPre+SG+P2
handicapé	handicaper	Ver:PPas+Mas+SG
handicapent	handicaper	Ver:IPre+PL+P3:SPre+PL+P3
handicapera	handicaper	Ver:IFut+SG+P3
handicaperaient	handicaper	Ver:CPre+PL+P3
handicaperai	handicaper	Ver:IFut+SG+P1
handicaperais	handicaper	Ver:CPre+SG+P1:CPre+SG+P2
handicaperait	handicaper	Ver:CPre+SG+P3
handicaperas	handicaper	Ver:IFut+SG+P2
handicapèrent	handicaper	Ver:IPSim+PL+P3
handicaperez	handicaper	Ver:IFut+PL+P2
handicaper	handicaper	Ver:Inf
handicaperiez	handicaper	Ver:CPre+PL+P2
handicaperions	handicaper	Ver:CPre+PL+P1
handicaperons	handicaper	Ver:IFut+PL+P1
handicaperont	handicaper	Ver:IFut+PL+P3
handicapés	handicapé	Adj:Mas+PL
handicapés	handicapé	Nom:Mas+PL
handicapes	handicaper	Ver:IPre+SG+P2:SPre+SG+P2
handicapés	handicaper	Ver:PPas+Mas+PL
handicapeur	handicapeur	Nom:Mas+SG
handicapez	handicaper	Ver:IPre+PL+P2:ImPre+PL+P2
handicap	handicap	Nom:Mas+SG
handicapiez	handicaper	Ver:IImp+PL+P2:SPre+PL+P2
handicapions	handicaper	Ver:IImp+PL+P1:SPre+PL+P1
handicapons	handicaper	Ver:IPre+PL+P1:ImPre+PL+P1
handicaps	handicap	Nom:Mas+PL
handisport	handisport	Adj:InvGen+InvPL
hand-ball	hand-ball	Nom:Mas+SG
hangar	hangar	Nom:Mas+SG
hangars	hangar	Nom:Mas+PL
han	han	Int
han	han	Nom:Mas+InvPL
hanneton	hanneton	Nom:Mas+SG
hannetonnage	hannetonnage	Nom:Mas+SG
hannetonnages	hannetonnage	Nom:Mas+PL
hannetonna	hannetonner	Ver:IPSim+SG+P3
hannetonnaient	hannetonner	Ver:IImp+PL+P3
hannetonnai	hannetonner	Ver:IPSim+SG+P1
hannetonnais	hannetonner	Ver:IImp+SG+P1:IImp+SG+P2
hannetonnait	hannetonner	Ver:IImp+SG+P3
hannetonnâmes	hannetonner	Ver:IPSim+PL+P1
hannetonnant	hannetonner	Ver:PPre
hannetonnas	hannetonner	Ver:IPSim+SG+P2
hannetonnasse	hannetonner	Ver:SImp+SG+P1
hannetonnassent	hannetonner	Ver:SImp+PL+P3
hannetonnasses	hannetonner	Ver:SImp+SG+P2
hannetonnassiez	hannetonner	Ver:SImp+PL+P2
hannetonnassions	hannetonner	Ver:SImp+PL+P1
hannetonnâtes	hannetonner	Ver:IPSim+PL+P2
hannetonnât	hannetonner	Ver:SImp+SG+P3
hannetonne	hannetonner	Ver:IPre+SG+P1:IPre+SG+P3:SPre+SG+P1:SPre+SG+P3:ImPre+SG+P2
hannetonné	hannetonner	Ver:PPas+Mas+SG
hannetonnent	hannetonner	Ver:IPre+PL+P3:SPre+PL+P3
hannetonnèrent	hannetonner	Ver:IPSim+PL+P3
hannetonner	hannetonner	Ver:Inf
hannetonnes	hannetonner	Ver:IPre+SG+P2:SPre+SG+P2
hannetonnez	hannetonner	Ver:IPre+PL+P2:ImPre+PL+P2
hannetonniez	hannetonner	Ver:IImp+PL+P2:SPre+PL+P2
hannetonnions	hannetonner	Ver:IImp+PL+P1:SPre+PL+P1
hannetonnons	hannetonner	Ver:IPre+PL+P1:ImPre+PL+P1
hannetons	hanneton	Nom:Mas+PL
hanovrien	hanovrien	Adj:Mas+SG
hanovrien	hanovrien	Nom:Mas+SG
hanovrienne	hanovrien	Adj:Fem+SG
hanovrienne	hanovrien	Nom:Fem+SG
hanovriennes	hanovrien	Adj:Fem+PL
hanovriennes	hanovrien	Nom:Fem+PL
hansart	hansart	Nom:Mas+SG
hanséatique	hanséatique	Adj:InvGen+SG
hanséatiques	hanséatique	Adj:InvGen+PL
hanse	hanse	Nom:Fem+SG
hanses	hanse	Nom:Fem+PL
hanta	hanter	Ver:IPSim+SG+P3
hantaient	hanter	Ver:IImp+PL+P3
hantai	hanter	Ver:IPSim+SG+P1
hantais	hanter	Ver:IImp+SG+P1:IImp+SG+P2
hantait	hanter	Ver:IImp+SG+P3
hantâmes	hanter	Ver:IPSim+PL+P1
hantant	hanter	Ver:PPre
hantas	hanter	Ver:IPSim+SG+P2
hantasse	hanter	Ver:SImp+SG+P1
hantassent	hanter	Ver:SImp+PL+P3
hantasses	hanter	Ver:SImp+SG+P2
hantassiez	hanter	Ver:SImp+PL+P2
hantassions	hanter	Ver:SImp+PL+P1
hantâtes	hanter	Ver:IPSim+PL+P2
hantât	hanter	Ver:SImp+SG+P3
hantée	hanté	Adj:Fem+SG
hantée	hanter	Ver:PPas+Fem+SG
hantées	hanté	Adj:Fem+PL
hantées	hanter	Ver:PPas+Fem+PL
hanté	hanté	Adj:Mas+SG
hante	hanter	Ver:IPre+SG+P1:IPre+SG+P3:SPre+SG+P1:SPre+SG+P3:ImPre+SG+P2
hanté	hanter	Ver:PPas+Mas+SG
hantent	hanter	Ver:IPre+PL+P3:SPre+PL+P3
hantera	hanter	Ver:IFut+SG+P3
hanteraient	hanter	Ver:CPre+PL+P3
hanterai	hanter	Ver:IFut+SG+P1
hanterais	hanter	Ver:CPre+SG+P1:CPre+SG+P2
hanterait	hanter	Ver:CPre+SG+P3
hanteras	hanter	Ver:IFut+SG+P2
hantèrent	hanter	Ver:IPSim+PL+P3
hanterez	hanter	Ver:IFut+PL+P2
hanter	hanter	Ver:Inf
hanteriez	hanter	Ver:CPre+PL+P2
hanterions	hanter	Ver:CPre+PL+P1
hanterons	hanter	Ver:IFut+PL+P1
hanteront	hanter	Ver:IFut+PL+P3
hantés	hanté	Adj:Mas+PL
hantes	hanter	Ver:IPre+SG+P2:SPre+SG+P2
hantés	hanter	Ver:PPas+Mas+PL
hantez	hanter	Ver:IPre+PL+P2:ImPre+PL+P2
hantiez	hanter	Ver:IImp+PL+P2:SPre+PL+P2
hantions	hanter	Ver:IImp+PL+P1:SPre+PL+P1
hantise	hantise	Nom:Fem+SG
hantises	hantise	Nom:Fem+PL
hantons	hanter	Ver:IPre+PL+P1:ImPre+PL+P1
haoussa	haoussa	Adj:InvGen+SG
haoussa	haoussa	Nom:InvGen+SG
haoussa	haoussa	Nom:Mas+SG
hapalidé	hapalidé	Nom:Mas+SG
hapax	hapax	Nom:Mas+InvPL
haploïde	haploïde	Adj:InvGen+SG
haplologie	haplologie	Nom:Fem+SG
haplophase	haplophase	Nom:Fem+SG
happa	happer	Ver:IPSim+SG+P3
happaient	happer	Ver:IImp+PL+P3
happai	happer	Ver:IPSim+SG+P1
happais	happer	Ver:IImp+SG+P1:IImp+SG+P2
happait	happer	Ver:IImp+SG+P3
happâmes	happer	Ver:IPSim+PL+P1
happant	happer	Ver:PPre
happas	happer	Ver:IPSim+SG+P2
happasse	happer	Ver:SImp+SG+P1
happassent	happer	Ver:SImp+PL+P3
happasses	happer	Ver:SImp+SG+P2
happassiez	happer	Ver:SImp+PL+P2
happassions	happer	Ver:SImp+PL+P1
happâtes	happer	Ver:IPSim+PL+P2
happât	happer	Ver:SImp+SG+P3
happée	happer	Ver:PPas+Fem+SG
happées	happer	Ver:PPas+Fem+PL
happe	happe	Nom:Fem+SG
happe	happer	Ver:IPre+SG+P1:IPre+SG+P3:SPre+SG+P1:SPre+SG+P3:ImPre+SG+P2
happé	happer	Ver:PPas+Mas+SG
happement	happement	Nom:Mas+SG
happening	happening	Nom:Mas+SG
happenings	happening	Nom:Mas+PL
happent	happer	Ver:IPre+PL+P3:SPre+PL+P3
happera	happer	Ver:IFut+SG+P3
happeraient	happer	Ver:CPre+PL+P3
happerai	happer	Ver:IFut+SG+P1
happerais	happer	Ver:CPre+SG+P1:CPre+SG+P2
happerait	happer	Ver:CPre+SG+P3
happeras	happer	Ver:IFut+SG+P2
happèrent	happer	Ver:IPSim+PL+P3
happerez	happer	Ver:IFut+PL+P2
happer	happer	Ver:Inf
happeriez	happer	Ver:CPre+PL+P2
happerions	happer	Ver:CPre+PL+P1
happerons	happer	Ver:IFut+PL+P1
happeront	happer	Ver:IFut+PL+P3
happes	happe	Nom:Fem+PL
happes	happer	Ver:IPre+SG+P2:SPre+SG+P2
happés	happer	Ver:PPas+Mas+PL
happez	happer	Ver:IPre+PL+P2:ImPre+PL+P2
happiez	happer	Ver:IImp+PL+P2:SPre+PL+P2
happions	happer	Ver:IImp+PL+P1:SPre+PL+P1
happons	happer	Ver:IPre+PL+P1:ImPre+PL+P1
haptène	haptène	Nom:Mas+SG
haquebute	haquebute	Nom:Fem+SG
haquenée	haquenée	Nom:Fem+SG
haquet	haquet	Nom:Mas+SG
harangua	haranguer	Ver:IPSim+SG+P3
haranguaient	haranguer	Ver:IImp+PL+P3
haranguai	haranguer	Ver:IPSim+SG+P1
haranguais	haranguer	Ver:IImp+SG+P1:IImp+SG+P2
haranguait	haranguer	Ver:IImp+SG+P3
haranguâmes	haranguer	Ver:IPSim+PL+P1
haranguant	haranguer	Ver:PPre
haranguas	haranguer	Ver:IPSim+SG+P2
haranguasse	haranguer	Ver:SImp+SG+P1
haranguassent	haranguer	Ver:SImp+PL+P3
haranguasses	haranguer	Ver:SImp+SG+P2
haranguassiez	haranguer	Ver:SImp+PL+P2
haranguassions	haranguer	Ver:SImp+PL+P1
haranguâtes	haranguer	Ver:IPSim+PL+P2
haranguât	haranguer	Ver:SImp+SG+P3
haranguée	haranguer	Ver:PPas+Fem+SG
haranguées	haranguer	Ver:PPas+Fem+PL
harangue	harangue	Nom:Fem+SG
harangué	haranguer	Ver:PPas+Mas+SG
haranguent	haranguer	Ver:IPre+PL+P3:SPre+PL+P3
haranguera	haranguer	Ver:IFut+SG+P3
harangueraient	haranguer	Ver:CPre+PL+P3
haranguerai	haranguer	Ver:IFut+SG+P1
haranguerais	haranguer	Ver:CPre+SG+P1:CPre+SG+P2
haranguerait	haranguer	Ver:CPre+SG+P3
harangueras	haranguer	Ver:IFut+SG+P2
haranguèrent	haranguer	Ver:IPSim+PL+P3
haranguerez	haranguer	Ver:IFut+PL+P2
haranguer	haranguer	Ver:Inf
harangueriez	haranguer	Ver:CPre+PL+P2
haranguerions	haranguer	Ver:CPre+PL+P1
haranguerons	haranguer	Ver:IFut+PL+P1
harangueront	haranguer	Ver:IFut+PL+P3
harangues	harangue	Nom:Fem+PL
harangués	haranguer	Ver:PPas+Mas+PL
harangueur	harangueur	Nom:Mas+SG
harangueuse	harangueur	Nom:Fem+SG
haranguez	haranguer	Ver:IPre+PL+P2:ImPre+PL+P2
haranguiez	haranguer	Ver:IImp+PL+P2:SPre+PL+P2
haranguions	haranguer	Ver:IImp+PL+P1:SPre+PL+P1
haranguons	haranguer	Ver:IPre+PL+P1:ImPre+PL+P1
haras	haras	Nom:Mas+InvPL
harassa	harasser	Ver:IPSim+SG+P3
harassaient	harasser	Ver:IImp+PL+P3
harassai	harasser	Ver:IPSim+SG+P1
harassais	harasser	Ver:IImp+SG+P1:IImp+SG+P2
harassait	harasser	Ver:IImp+SG+P3
harassâmes	harasser	Ver:IPSim+PL+P1
harassante	harassant	Adj:Fem+SG
harassantes	harassant	Adj:Fem+PL
harassant	harassant	Adj:Mas+SG
harassant	harasser	Ver:PPre
harassants	harassant	Adj:Mas+PL
harassas	harasser	Ver:IPSim+SG+P2
harassasse	harasser	Ver:SImp+SG+P1
harassassent	harasser	Ver:SImp+PL+P3
harassasses	harasser	Ver:SImp+SG+P2
harassassiez	harasser	Ver:SImp+PL+P2
harassassions	harasser	Ver:SImp+PL+P1
harassâtes	harasser	Ver:IPSim+PL+P2
harassât	harasser	Ver:SImp+SG+P3
harassée	harassé	Adj:Fem+SG
harassée	harasser	Ver:PPas+Fem+SG
harassées	harassé	Adj:Fem+PL
harassées	harasser	Ver:PPas+Fem+PL
harassé	harassé	Adj:Mas+SG
harasse	harasse	Nom:Fem+SG
harasse	harasser	Ver:IPre+SG+P1:IPre+SG+P3:SPre+SG+P1:SPre+SG+P3:ImPre+SG+P2
harassé	harasser	Ver:PPas+Mas+SG
harassement	harassement	Nom:Mas+SG
harassent	harasser	Ver:IPre+PL+P3:SPre+PL+P3
harassèrent	harasser	Ver:IPSim+PL+P3
harasser	harasser	Ver:Inf
harassés	harassé	Adj:Mas+PL
harasses	harasse	Nom:Fem+PL
harasses	harasser	Ver:IPre+SG+P2:SPre+SG+P2
harassés	harasser	Ver:PPas+Mas+PL
harassez	harasser	Ver:IPre+PL+P2:ImPre+PL+P2
harassiez	harasser	Ver:IImp+PL+P2:SPre+PL+P2
harassions	harasser	Ver:IImp+PL+P1:SPre+PL+P1
harassons	harasser	Ver:IPre+PL+P1:ImPre+PL+P1
hara-kiri	hara-kiri	Nom:Mas+SG
harcela	harceler	Ver:IPSim+SG+P3
harcelaient	harceler	Ver:IImp+PL+P3
harcelai	harceler	Ver:IPSim+SG+P1
harcelais	harceler	Ver:IImp+SG+P1:IImp+SG+P2
harcelait	harceler	Ver:IImp+SG+P3
harcelâmes	harceler	Ver:IPSim+PL+P1
harcelante	harcelant	Adj:Fem+SG
harcelantes	harcelant	Adj:Fem+PL
harcelant	harcelant	Adj:Mas+SG
harcelas	harceler	Ver:IPSim+SG+P2
harcelasse	harceler	Ver:SImp+SG+P1
harcelassent	harceler	Ver:SImp+PL+P3
harcelasses	harceler	Ver:SImp+SG+P2
harcelassiez	harceler	Ver:SImp+PL+P2
harcelassions	harceler	Ver:SImp+PL+P1
harcelâtes	harceler	Ver:IPSim+PL+P2
harcelât	harceler	Ver:SImp+SG+P3
harcelée	harcelé	Adj:Fem+SG
harcelée	harceler	Ver:PPas+Fem+SG
harcelées	harcelé	Adj:Fem+PL
harcelées	harceler	Ver:PPas+Fem+PL
harcelé	harcelé	Adj:Mas+SG
harcèle	harceler	Ver:Imp+SG+P2
harcèle	harceler	Ver:IPre+SG+P1
harcèle	harceler	Ver:IPre+SG+P3
harcèle	harceler	Ver:SPre+SG+P1
harcèle	harceler	Ver:SPre+SG+P3
harcèlement	harcèlement	Nom:Mas+SG
harcèlements	harcèlement	Nom:Mas+PL
harcèlent	harceler	Ver:IPre+PL+P3
harcèlent	harceler	Ver:SPre+PL+P3
harcèlera	harceler	Ver:IFut+SG+P3
harcèleraient	harceler	Ver:CPre+PL+P3
harcèlerai	harceler	Ver:IFut+SG+P1
harcèlerais	harceler	Ver:CPre+SG+P1
harcèlerais	harceler	Ver:CPre+SG+P2
harcèlerait	harceler	Ver:CPre+SG+P3
harcèleras	harceler	Ver:IFut+SG+P2
harcelèrent	harceler	Ver:IPSim+PL+P3
harcèlerez	harceler	Ver:IFut+PL+P2
harceler	harceler	Ver:Inf
harcèleriez	harceler	Ver:CPre+PL+P2
harcèlerions	harceler	Ver:CPre+PL+P1
harcèlerons	harceler	Ver:IFut+PL+P1
harcèleront	harceler	Ver:IFut+PL+P3
harcelés	harcelé	Adj:Mas+PL
harcèles	harceler	Ver:IPre+SG+P2
harcelés	harceler	Ver:PPas+Mas+PL
harcèles	harceler	Ver:SPre+SG+P2
harcelez	harceler	Ver:IPre+PL+P2:ImPre+PL+P2
harceliez	harceler	Ver:IImp+PL+P2:SPre+PL+P2
harcelions	harceler	Ver:IImp+PL+P1:SPre+PL+P1
harcelle	harceler	Ver:IPre+SG+P1:IPre+SG+P3:SPre+SG+P1:SPre+SG+P3:ImPre+SG+P2
harcellent	harceler	Ver:IPre+PL+P3:SPre+PL+P3
harcellera	harceler	Ver:IFut+SG+P3
harcelleraient	harceler	Ver:CPre+PL+P3
harcellerai	harceler	Ver:IFut+SG+P1
harcellerais	harceler	Ver:CPre+SG+P1:CPre+SG+P2
harcellerait	harceler	Ver:CPre+SG+P3
harcelleras	harceler	Ver:IFut+SG+P2
harcellerez	harceler	Ver:IFut+PL+P2
harcelleriez	harceler	Ver:CPre+PL+P2
harcellerions	harceler	Ver:CPre+PL+P1
harcellerons	harceler	Ver:IFut+PL+P1
harcelleront	harceler	Ver:IFut+PL+P3
harcelles	harceler	Ver:IPre+SG+P2:SPre+SG+P2
harcelons	harceler	Ver:IPre+PL+P1:ImPre+PL+P1
harda	harder	Ver:IPSim+SG+P3
hardaient	harder	Ver:IImp+PL+P3
hardai	harder	Ver:IPSim+SG+P1
hardais	harder	Ver:IImp+SG+P1:IImp+SG+P2
hardait	harder	Ver:IImp+SG+P3
hardâmes	harder	Ver:IPSim+PL+P1
hardant	harder	Ver:PPre
hardas	harder	Ver:IPSim+SG+P2
hardasse	harder	Ver:SImp+SG+P1
hardassent	harder	Ver:SImp+PL+P3
hardasses	harder	Ver:SImp+SG+P2
hardassiez	harder	Ver:SImp+PL+P2
hardassions	harder	Ver:SImp+PL+P1
hardâtes	harder	Ver:IPSim+PL+P2
hardât	harder	Ver:SImp+SG+P3
hardé	hardé	Adj:Mas+SG
harde	harde	Nom:Fem+SG
hardé	harder	Ver:PPas+Mas+SG
hardent	harder	Ver:IPre+PL+P3:SPre+PL+P3
hardera	harder	Ver:IFut+SG+P3
harderaient	harder	Ver:CPre+PL+P3
harderai	harder	Ver:IFut+SG+P1
harderais	harder	Ver:CPre+SG+P1:CPre+SG+P2
harderait	harder	Ver:CPre+SG+P3
harderas	harder	Ver:IFut+SG+P2
hardèrent	harder	Ver:IPSim+PL+P3
harderez	harder	Ver:IFut+PL+P2
harder	harder	Ver:Inf
harderiez	harder	Ver:CPre+PL+P2
harderions	harder	Ver:CPre+PL+P1
harderons	harder	Ver:IFut+PL+P1
harderont	harder	Ver:IFut+PL+P3
hardes	harde	Nom:Fem+PL
hardes	harder	Ver:IPre+SG+P2:SPre+SG+P2
hardes	hardes	Nom:Fem+PL
hardez	harder	Ver:IPre+PL+P2:ImPre+PL+P2
hard	hard	Adj:InvGen+SG:InvGen+PL
hard	hard	Nom:Mas+InvPL
hardie	hardi	Adj:Fem+SG
hardies	hardi	Adj:Fem+PL
hardiesse	hardiesse	Nom:Fem+SG
hardiesses	hardiesse	Nom:Fem+PL
hardiez	harder	Ver:IImp+PL+P2:SPre+PL+P2
hardi	hardi	Adj:Mas+SG
hardi	hardi	Int
hardi	hardi	Nom:Mas+SG
hardiment	hardiment	Adv
hardions	harder	Ver:IImp+PL+P1:SPre+PL+P1
hardis	hardi	Adj:Mas+PL
hardis	hardi	Nom:Mas+PL
hardons	harder	Ver:IPre+PL+P1:ImPre+PL+P1
hardware	hardware	Nom:Mas+SG
hard-top	hard-top	Nom:Mas+SG
harem	harem	Nom:Fem+SG
harem	harem	Nom:Mas+SG
harems	harem	Nom:Fem+PL
harems	harem	Nom:Mas+PL
harengaison	harengaison	Nom:Fem+SG
harengère	harengère	Nom:Fem+SG
harengères	harengère	Nom:Fem+PL
hareng	hareng	Nom:Mas+SG
harengs	hareng	Nom:Mas+PL
harenguet	harenguet	Nom:Mas+SG
harengueux	harengueux	Nom:Mas+InvPL
harenguier	harenguier	Nom:Mas+SG
haret	haret	Adj:Mas+SG
haret	haret	Nom:Mas+SG
harfang	harfang	Nom:Mas+SG
hargne	hargne	Nom:Fem+SG
hargneuse	hargneux	Adj:Fem+SG
hargneusement	hargneusement	Adv
hargneuses	hargneux	Adj:Fem+PL
hargneux	hargneux	Adj:Mas+InvPL
haricot	haricot	Nom:Mas+SG
haricots	haricot	Nom:Mas+PL
haridelle	haridelle	Nom:Fem+SG
harissa	harissa	Nom:Mas+SG
harki	harki	Nom:Mas+SG
harle	harle	Nom:Mas+SG
harmattan	harmattan	Nom:Mas+SG
harmonica	harmonica	Nom:Mas+SG
harmonicas	harmonica	Nom:Mas+PL
harmoniciste	harmoniciste	Nom:InvGen+SG
harmonicistes	harmoniciste	Nom:InvGen+PL
harmonicorde	harmonicorde	Nom:Mas+SG
harmonie	harmonie	Nom:Fem+SG
harmonie	harmonier	Ver:IPre+SG+P1:IPre+SG+P3:SPre+SG+P1:SPre+SG+P3:ImPre+SG+P2
harmonies	harmonie	Nom:Fem+PL
harmonies	harmonier	Ver:IPre+SG+P2:SPre+SG+P2
harmonieuse	harmonieux	Adj:Fem+SG
harmonieusement	harmonieusement	Adv
harmonieuses	harmonieux	Adj:Fem+PL
harmonieux	harmonieux	Adj:Mas+InvPL
harmonique	harmonique	Adj:InvGen+SG
harmonique	harmonique	Nom:Fem+SG
harmonique	harmonique	Nom:Mas+SG
harmoniquement	harmoniquement	Adv
harmoniques	harmonique	Adj:InvGen+PL
harmoniques	harmonique	Nom:Fem+PL
harmoniques	harmonique	Nom:Mas+PL
harmonisa	harmoniser	Ver:IPSim+SG+P3
harmonisaient	harmoniser	Ver:IImp+PL+P3
harmonisai	harmoniser	Ver:IPSim+SG+P1
harmonisais	harmoniser	Ver:IImp+SG+P1:IImp+SG+P2
harmonisait	harmoniser	Ver:IImp+SG+P3
harmonisâmes	harmoniser	Ver:IPSim+PL+P1
harmonisant	harmoniser	Ver:PPre
harmonisas	harmoniser	Ver:IPSim+SG+P2
harmonisasse	harmoniser	Ver:SImp+SG+P1
harmonisassent	harmoniser	Ver:SImp+PL+P3
harmonisasses	harmoniser	Ver:SImp+SG+P2
harmonisassiez	harmoniser	Ver:SImp+PL+P2
harmonisassions	harmoniser	Ver:SImp+PL+P1
harmonisâtes	harmoniser	Ver:IPSim+PL+P2
harmonisât	harmoniser	Ver:SImp+SG+P3
harmonisation	harmonisation	Nom:Fem+SG
harmonisations	harmonisation	Nom:Fem+PL
harmonisée	harmoniser	Ver:PPas+Fem+SG
harmonisées	harmoniser	Ver:PPas+Fem+PL
harmonise	harmoniser	Ver:IPre+SG+P1:IPre+SG+P3:SPre+SG+P1:SPre+SG+P3:ImPre+SG+P2
harmonisé	harmoniser	Ver:PPas+Mas+SG
harmonisent	harmoniser	Ver:IPre+PL+P3:SPre+PL+P3
harmonisera	harmoniser	Ver:IFut+SG+P3
harmoniseraient	harmoniser	Ver:CPre+PL+P3
harmoniserai	harmoniser	Ver:IFut+SG+P1
harmoniserais	harmoniser	Ver:CPre+SG+P1:CPre+SG+P2
harmoniserait	harmoniser	Ver:CPre+SG+P3
harmoniseras	harmoniser	Ver:IFut+SG+P2
harmonisèrent	harmoniser	Ver:IPSim+PL+P3
harmoniserez	harmoniser	Ver:IFut+PL+P2
harmoniser	harmoniser	Ver:Inf
harmoniseriez	harmoniser	Ver:CPre+PL+P2
harmoniserions	harmoniser	Ver:CPre+PL+P1
harmoniserons	harmoniser	Ver:IFut+PL+P1
harmoniseront	harmoniser	Ver:IFut+PL+P3
harmonises	harmoniser	Ver:IPre+SG+P2:SPre+SG+P2
harmonisés	harmoniser	Ver:PPas+Mas+PL
harmonisez	harmoniser	Ver:IPre+PL+P2:ImPre+PL+P2
harmonisiez	harmoniser	Ver:IImp+PL+P2:SPre+PL+P2
harmonisions	harmoniser	Ver:IImp+PL+P1:SPre+PL+P1
harmonisons	harmoniser	Ver:IPre+PL+P1:ImPre+PL+P1
harmonium	harmonium	Nom:Mas+SG
harmoniums	harmonium	Nom:Mas+PL
harnacha	harnacher	Ver:IPSim+SG+P3
harnachaient	harnacher	Ver:IImp+PL+P3
harnachai	harnacher	Ver:IPSim+SG+P1
harnachais	harnacher	Ver:IImp+SG+P1:IImp+SG+P2
harnachait	harnacher	Ver:IImp+SG+P3
harnachâmes	harnacher	Ver:IPSim+PL+P1
harnachant	harnacher	Ver:PPre
harnachas	harnacher	Ver:IPSim+SG+P2
harnachasse	harnacher	Ver:SImp+SG+P1
harnachassent	harnacher	Ver:SImp+PL+P3
harnachasses	harnacher	Ver:SImp+SG+P2
harnachassiez	harnacher	Ver:SImp+PL+P2
harnachassions	harnacher	Ver:SImp+PL+P1
harnachâtes	harnacher	Ver:IPSim+PL+P2
harnachât	harnacher	Ver:SImp+SG+P3
harnache	harnacher	Ver:IPre+SG+P1:IPre+SG+P3:SPre+SG+P1:SPre+SG+P3:ImPre+SG+P2
harnaché	harnacher	Ver:PPas+Mas+SG
harnachement	harnachement	Nom:Mas+SG
harnachements	harnachement	Nom:Mas+PL
harnachent	harnacher	Ver:IPre+PL+P3:SPre+PL+P3
harnachèrent	harnacher	Ver:IPSim+PL+P3
harnacher	harnacher	Ver:Inf
harnaches	harnacher	Ver:IPre+SG+P2:SPre+SG+P2
harnacheur	harnacheur	Nom:Mas+SG
harnachez	harnacher	Ver:IPre+PL+P2:ImPre+PL+P2
harnachiez	harnacher	Ver:IImp+PL+P2:SPre+PL+P2
harnachions	harnacher	Ver:IImp+PL+P1:SPre+PL+P1
harnachons	harnacher	Ver:IPre+PL+P1:ImPre+PL+P1
harnais	harnais	Nom:Mas+InvPL
harnois	harnois	Nom:Mas+InvPL
haro	haro	Int
haro	haro	Nom:Mas+SG
haros	haro	Nom:Mas+PL
harpagon	harpagon	Nom:Mas+SG
harpail	harpail	Nom:Mas+SG
harpaille	harpaille	Nom:Fem+SG
harpaille	harpailler	Ver:IPre+SG+P1:IPre+SG+P3:SPre+SG+P1:SPre+SG+P3:ImPre+SG+P2
harpailler	harpailler	Ver:Inf
harpailles	harpaille	Nom:Fem+PL
harpailles	harpailler	Ver:IPre+SG+P2:SPre+SG+P2
harpe	harpe	Nom:Fem+SG
harper	harper	Ver:Inf
harpes	harpe	Nom:Fem+PL
harpes	harper	Ver:IPre+SG+P2:SPre+SG+P2
harpes	harpes	Nom:Mas+InvPL
harpie	harpie	Nom:Fem+SG
harpies	harpie	Nom:Fem+PL
harpiste	harpiste	Nom:InvGen+SG
harpistes	harpiste	Nom:InvGen+PL
harpon	harpon	Nom:Mas+SG
harponnage	harponnage	Nom:Mas+SG
harponnages	harponnage	Nom:Mas+PL
harponna	harponner	Ver:IPSim+SG+P3
harponnaient	harponner	Ver:IImp+PL+P3
harponnai	harponner	Ver:IPSim+SG+P1
harponnais	harponner	Ver:IImp+SG+P1:IImp+SG+P2
harponnait	harponner	Ver:IImp+SG+P3
harponnâmes	harponner	Ver:IPSim+PL+P1
harponnant	harponner	Ver:PPre
harponnas	harponner	Ver:IPSim+SG+P2
harponnasse	harponner	Ver:SImp+SG+P1
harponnassent	harponner	Ver:SImp+PL+P3
harponnasses	harponner	Ver:SImp+SG+P2
harponnassiez	harponner	Ver:SImp+PL+P2
harponnassions	harponner	Ver:SImp+PL+P1
harponnâtes	harponner	Ver:IPSim+PL+P2
harponnât	harponner	Ver:SImp+SG+P3
harponnée	harponner	Ver:PPas+Fem+SG
harponnées	harponner	Ver:PPas+Fem+PL
harponne	harponner	Ver:IPre+SG+P1:IPre+SG+P3:SPre+SG+P1:SPre+SG+P3:ImPre+SG+P2
harponné	harponner	Ver:PPas+Mas+SG
harponnement	harponnement	Nom:Mas+SG
harponnent	harponner	Ver:IPre+PL+P3:SPre+PL+P3
harponnera	harponner	Ver:IFut+SG+P3
harponneraient	harponner	Ver:CPre+PL+P3
harponnerai	harponner	Ver:IFut+SG+P1
harponnerais	harponner	Ver:CPre+SG+P1:CPre+SG+P2
harponnerait	harponner	Ver:CPre+SG+P3
harponneras	harponner	Ver:IFut+SG+P2
harponnèrent	harponner	Ver:IPSim+PL+P3
harponnerez	harponner	Ver:IFut+PL+P2
harponner	harponner	Ver:Inf
harponneriez	harponner	Ver:CPre+PL+P2
harponnerions	harponner	Ver:CPre+PL+P1
harponnerons	harponner	Ver:IFut+PL+P1
harponneront	harponner	Ver:IFut+PL+P3
harponnes	harponner	Ver:IPre+SG+P2:SPre+SG+P2
harponnés	harponner	Ver:PPas+Mas+PL
harponneur	harponneur	Nom:Mas+SG
harponnez	harponner	Ver:IPre+PL+P2:ImPre+PL+P2
harponniez	harponner	Ver:IImp+PL+P2:SPre+PL+P2
harponnions	harponner	Ver:IImp+PL+P1:SPre+PL+P1
harponnons	harponner	Ver:IPre+PL+P1:ImPre+PL+P1
harpons	harper	Ver:IPre+PL+P1:ImPre+PL+P1
harpons	harpon	Nom:Mas+PL
hart	hart	Nom:Fem+SG
haruspice	haruspice	Nom:Mas+SG
hasarda	hasarder	Ver:IPSim+SG+P3
hasardaient	hasarder	Ver:IImp+PL+P3
hasardai	hasarder	Ver:IPSim+SG+P1
hasardais	hasarder	Ver:IImp+SG+P1:IImp+SG+P2
hasardait	hasarder	Ver:IImp+SG+P3
hasardâmes	hasarder	Ver:IPSim+PL+P1
hasardant	hasarder	Ver:PPre
hasardas	hasarder	Ver:IPSim+SG+P2
hasardasse	hasarder	Ver:SImp+SG+P1
hasardassent	hasarder	Ver:SImp+PL+P3
hasardasses	hasarder	Ver:SImp+SG+P2
hasardassiez	hasarder	Ver:SImp+PL+P2
hasardassions	hasarder	Ver:SImp+PL+P1
hasardâtes	hasarder	Ver:IPSim+PL+P2
hasardât	hasarder	Ver:SImp+SG+P3
hasardée	hasarder	Ver:PPas+Fem+SG
hasardées	hasarder	Ver:PPas+Fem+PL
hasarde	hasarder	Ver:IPre+SG+P1:IPre+SG+P3:SPre+SG+P1:SPre+SG+P3:ImPre+SG+P2
hasardé	hasarder	Ver:PPas+Mas+SG
hasardent	hasarder	Ver:IPre+PL+P3:SPre+PL+P3
hasardera	hasarder	Ver:IFut+SG+P3
hasarderaient	hasarder	Ver:CPre+PL+P3
hasarderai	hasarder	Ver:IFut+SG+P1
hasarderais	hasarder	Ver:CPre+SG+P1:CPre+SG+P2
hasarderait	hasarder	Ver:CPre+SG+P3
hasarderas	hasarder	Ver:IFut+SG+P2
hasardèrent	hasarder	Ver:IPSim+PL+P3
hasarderez	hasarder	Ver:IFut+PL+P2
hasarder	hasarder	Ver:Inf
hasarderiez	hasarder	Ver:CPre+PL+P2
hasarderions	hasarder	Ver:CPre+PL+P1
hasarderons	hasarder	Ver:IFut+PL+P1
hasarderont	hasarder	Ver:IFut+PL+P3
hasardés	hasardé	Adj:Mas+PL
hasardes	hasarder	Ver:IPre+SG+P2:SPre+SG+P2
hasardés	hasarder	Ver:PPas+Mas+PL
hasardeuse	hasardeux	Adj:Fem+SG
hasardeuses	hasardeux	Adj:Fem+PL
hasardeux	hasardeux	Adj:Mas+InvPL
hasardez	hasarder	Ver:IPre+PL+P2:ImPre+PL+P2
hasard	hasard	Nom:Mas+SG
hasardiez	hasarder	Ver:IImp+PL+P2:SPre+PL+P2
hasardions	hasarder	Ver:IImp+PL+P1:SPre+PL+P1
hasardons	hasarder	Ver:IPre+PL+P1:ImPre+PL+P1
hasards	hasard	Nom:Mas+PL
hasch	hasch	Nom:Mas+InvPL
haschich	haschich	Nom:Mas+InvPL
haschisch	haschisch	Nom:Mas+InvPL
haschischin	haschischin	Nom:Mas+SG
hase	hase	Nom:Fem+SG
hases	hase	Nom:Fem+PL
hassidisme	hassidisme	Nom:Mas+SG
hassidismes	hassidisme	Nom:Mas+PL
hastaire	hastaire	Nom:Mas+SG
hastée	hasté	Adj:Fem+SG
hastées	hasté	Adj:Fem+PL
hasté	hasté	Adj:Mas+SG
hast	hast	Nom:Mas+SG
hâta	hâter	Ver:IPSim+SG+P3
hâtaient	hâter	Ver:IImp+PL+P3
hâtai	hâter	Ver:IPSim+SG+P1
hâtais	hâter	Ver:IImp+SG+P1:IImp+SG+P2
hâtait	hâter	Ver:IImp+SG+P3
hâtâmes	hâter	Ver:IPSim+PL+P1
hâtant	hâter	Ver:PPre
hâtas	hâter	Ver:IPSim+SG+P2
hâtasse	hâter	Ver:SImp+SG+P1
hâtassent	hâter	Ver:SImp+PL+P3
hâtasses	hâter	Ver:SImp+SG+P2
hâtassiez	hâter	Ver:SImp+PL+P2
hâtassions	hâter	Ver:SImp+PL+P1
hâtâtes	hâter	Ver:IPSim+PL+P2
hâtât	hâter	Ver:SImp+SG+P3
hâtée	hâter	Ver:PPas+Fem+SG
hâtées	hâter	Ver:PPas+Fem+PL
hâte	hâte	Nom:Fem+SG
hâte	hâter	Ver:IPre+SG+P1:IPre+SG+P3:SPre+SG+P1:SPre+SG+P3:ImPre+SG+P2
hâté	hâter	Ver:PPas+Mas+SG
hâtelet	hâtelet	Nom:Mas+SG
hâtelette	hâtelette	Nom:Fem+SG
hâtelettes	hâtelette	Nom:Fem+PL
hâtelle	hâtelle	Nom:Fem+SG
hâtent	hâter	Ver:IPre+PL+P3:SPre+PL+P3
hâtera	hâter	Ver:IFut+SG+P3
hâteraient	hâter	Ver:CPre+PL+P3
hâterai	hâter	Ver:IFut+SG+P1
hâterais	hâter	Ver:CPre+SG+P1:CPre+SG+P2
hâterait	hâter	Ver:CPre+SG+P3
hâteras	hâter	Ver:IFut+SG+P2
hâtereau	hâtereau	Nom:Mas+SG
hâtereaux	hâtereau	Nom:Mas+PL
hâtèrent	hâter	Ver:IPSim+PL+P3
hâterez	hâter	Ver:IFut+PL+P2
hâter	hâter	Ver:Inf
hâteriez	hâter	Ver:CPre+PL+P2
hâterions	hâter	Ver:CPre+PL+P1
hâterons	hâter	Ver:IFut+PL+P1
hâteront	hâter	Ver:IFut+PL+P3
hâtes	hâte	Nom:Fem+PL
hâtes	hâter	Ver:IPre+SG+P2:SPre+SG+P2
hâtés	hâter	Ver:PPas+Mas+PL
hâtez	hâter	Ver:IPre+PL+P2:ImPre+PL+P2
hâtier	hâtier	Nom:Mas+SG
hâtiers	hâtier	Nom:Mas+PL
hâtiez	hâter	Ver:IImp+PL+P2:SPre+PL+P2
hâtif	hâtif	Adj:Mas+SG
hâtifs	hâtif	Adj:Mas+PL
hâtions	hâter	Ver:IImp+PL+P1:SPre+PL+P1
hâtiveau	hâtiveau	Nom:Mas+SG
hâtiveaux	hâtiveau	Nom:Mas+PL
hâtive	hâtif	Adj:Fem+SG
hâtivement	hâtivement	Adv
hâtives	hâtif	Adj:Fem+PL
hâtons	hâter	Ver:IPre+PL+P1:ImPre+PL+P1
hattéria	hattéria	Nom:Mas+SG
haubanage	haubanage	Nom:Mas+SG
haubanages	haubanage	Nom:Mas+PL
haubana	haubaner	Ver:IPSim+SG+P3
haubanaient	haubaner	Ver:IImp+PL+P3
haubanai	haubaner	Ver:IPSim+SG+P1
haubanais	haubaner	Ver:IImp+SG+P1:IImp+SG+P2
haubanait	haubaner	Ver:IImp+SG+P3
haubanâmes	haubaner	Ver:IPSim+PL+P1
haubanant	haubaner	Ver:PPre
haubanas	haubaner	Ver:IPSim+SG+P2
haubanasse	haubaner	Ver:SImp+SG+P1
haubanassent	haubaner	Ver:SImp+PL+P3
haubanasses	haubaner	Ver:SImp+SG+P2
haubanassiez	haubaner	Ver:SImp+PL+P2
haubanassions	haubaner	Ver:SImp+PL+P1
haubanâtes	haubaner	Ver:IPSim+PL+P2
haubanât	haubaner	Ver:SImp+SG+P3
haubane	haubaner	Ver:IPre+SG+P1:IPre+SG+P3:SPre+SG+P1:SPre+SG+P3:ImPre+SG+P2
haubané	haubaner	Ver:PPas+Mas+SG
haubanent	haubaner	Ver:IPre+PL+P3:SPre+PL+P3
haubanèrent	haubaner	Ver:IPSim+PL+P3
haubaner	haubaner	Ver:Inf
haubanes	haubaner	Ver:IPre+SG+P2:SPre+SG+P2
haubanez	haubaner	Ver:IPre+PL+P2:ImPre+PL+P2
hauban	hauban	Nom:Mas+SG
haubaniez	haubaner	Ver:IImp+PL+P2:SPre+PL+P2
haubanions	haubaner	Ver:IImp+PL+P1:SPre+PL+P1
haubanons	haubaner	Ver:IPre+PL+P1:ImPre+PL+P1
haubans	hauban	Nom:Mas+PL
haubert	haubert	Nom:Mas+SG
hauberts	haubert	Nom:Mas+PL
haussa	hausser	Ver:IPSim+SG+P3
haussaient	hausser	Ver:IImp+PL+P3
haussai	hausser	Ver:IPSim+SG+P1
haussais	hausser	Ver:IImp+SG+P1:IImp+SG+P2
haussait	hausser	Ver:IImp+SG+P3
haussâmes	hausser	Ver:IPSim+PL+P1
haussant	hausser	Ver:PPre
haussas	hausser	Ver:IPSim+SG+P2
haussasse	hausser	Ver:SImp+SG+P1
haussassent	hausser	Ver:SImp+PL+P3
haussasses	hausser	Ver:SImp+SG+P2
haussassiez	hausser	Ver:SImp+PL+P2
haussassions	hausser	Ver:SImp+PL+P1
haussâtes	hausser	Ver:IPSim+PL+P2
haussât	hausser	Ver:SImp+SG+P3
haussée	hausser	Ver:PPas+Fem+SG
haussées	hausser	Ver:PPas+Fem+PL
hausse	hausse	Nom:Fem+SG
hausse	hausser	Ver:IPre+SG+P1:IPre+SG+P3:SPre+SG+P1:SPre+SG+P3:ImPre+SG+P2
haussé	hausser	Ver:PPas+Mas+SG
haussement	haussement	Nom:Mas+SG
haussements	haussement	Nom:Mas+PL
haussent	hausser	Ver:IPre+PL+P3:SPre+PL+P3
haussera	hausser	Ver:IFut+SG+P3
hausseraient	hausser	Ver:CPre+PL+P3
hausserai	hausser	Ver:IFut+SG+P1
hausserais	hausser	Ver:CPre+SG+P1:CPre+SG+P2
hausserait	hausser	Ver:CPre+SG+P3
hausseras	hausser	Ver:IFut+SG+P2
haussèrent	hausser	Ver:IPSim+PL+P3
hausserez	hausser	Ver:IFut+PL+P2
hausser	hausser	Ver:Inf
hausseriez	hausser	Ver:CPre+PL+P2
hausserions	hausser	Ver:CPre+PL+P1
hausserons	hausser	Ver:IFut+PL+P1
hausseront	hausser	Ver:IFut+PL+P3
hausses	hausse	Nom:Fem+PL
hausses	hausser	Ver:IPre+SG+P2:SPre+SG+P2
haussés	hausser	Ver:PPas+Mas+PL
haussez	hausser	Ver:IPre+PL+P2:ImPre+PL+P2
hausse-col	hausse-col	Nom:Mas+SG
haussière	haussier	Adj:Fem+SG
haussière	haussière	Nom:Fem+SG
haussière	haussier	Nom:Fem+SG
haussières	haussier	Adj:Fem+PL
haussières	haussière	Nom:Fem+PL
haussières	haussières	Nom:Fem+PL
haussières	haussier	Nom:Fem+PL
haussier	haussier	Adj:Mas+SG
haussier	haussier	Nom:Mas+SG
haussiers	haussier	Adj:Mas+PL
haussiers	haussier	Nom:Mas+PL
haussiez	hausser	Ver:IImp+PL+P2:SPre+PL+P2
haussions	hausser	Ver:IImp+PL+P1:SPre+PL+P1
haussons	hausser	Ver:IPre+PL+P1:ImPre+PL+P1
hautaine	hautain	Adj:Fem+SG
hautaine	hautain	Nom:Fem+SG
hautaines	hautain	Adj:Fem+PL
hautaines	hautain	Nom:Fem+PL
hautain	hautain	Adj:Mas+SG
hautains	hautain	Adj:Mas+PL
hautbois	hautbois	Nom:Mas+InvPL
hautboïste	hautboïste	Nom:InvGen+SG
hautboïstes	hautboïste	Nom:InvGen+PL
haute	haut	Adj:Fem+SG
haute	haute	Nom:Fem+SG
hautement	hautement	Adv
hautes	haut	Adj:Fem+PL
hautes	haute	Nom:Fem+PL
hautesse	hautesse	Nom:Fem+SG
hautes-contre	haute-contre	Adj:Fem+PL
hautes-contre	haute-contre	Adj:Mas+PL
hautes-contre	haute-contre	Nom:Fem+PL
hautes-contre	haute-contre	Nom:Mas+PL
hautes-fidélités	haute-fidélité	Nom:Fem+PL
hauteur	hauteur	Nom:Fem+SG
hauteurs	hauteur	Nom:Fem+PL
hauteurs	hauteurs	Nom:Fem+PL
haute-contre	haute-contre	Adj:Fem+SG
haute-contre	haute-contre	Adj:Mas+SG
haute-contre	haute-contre	Nom:Fem+SG
haute-contre	haute-contre	Nom:Mas+SG
haute-fidélité	haute-fidélité	Nom:Fem+SG
haut	haut	Adj:Mas+SG
haut	haut	Adv
haut	haut	Nom:Mas+SG
hautin	hautin	Nom:Mas+SG
hauts	haut	Adj:Mas+PL
hauts	haut	Nom:Mas+PL
hauts	hauts	Nom:Mas+PL
hauts-commissaires	haut-commissaire	Nom:Mas+PL
hauts-de-chausses	haut-de-chausses	Nom:Mas+PL
hauts-de-forme	haut-de-forme	Nom:Mas+PL
hauts-fonds	haut-fond	Nom:Mas+PL
hauts-reliefs	haut-relief	Nom:Mas+PL
hauturière	hauturier	Adj:Fem+SG
hauturier	hauturier	Adj:Mas+SG
haut-commissaire	haut-commissaire	Nom:Mas+SG
haut-de-chausse	haut-de-chausse	Nom:Mas+SG
haut-de-chausses	haut-de-chausses	Nom:Mas+SG
haut-de-forme	haut-de-forme	Nom:Mas+SG
haut-fond	haut-fond	Nom:Mas+SG
haut-le-coeur	haut-le-coeur	Nom:Mas+InvPL
haut-le-corps	haut-le-corps	Nom:Mas+InvPL
haut-parleur	haut-parleur	Nom:Mas+SG
haut-parleurs	haut-parleur	Nom:Mas+PL
haut-relief	haut-relief	Nom:Mas+SG
havage	havage	Nom:Mas+SG
havanaise	havanais	Adj:Fem+SG
havanaise	havanaise	Nom:Fem+SG
havanaise	havanais	Nom:Fem+SG
havanais	havanais	Adj:Mas+InvPL
havanais	havanais	Nom:Mas+InvPL
havane	havane	Adj:InvGen+SG:InvGen+PL
havane	havane	Nom:Mas+SG
havanes	havane	Nom:Mas+PL
hâve	hâve	Adj:InvGen+SG
haveneau	haveneau	Nom:Mas+SG
haveneaux	haveneau	Nom:Mas+PL
havenet	havenet	Nom:Mas+SG
haver	haver	Ver:Inf
hâves	hâve	Adj:InvGen+PL
haveur	haveur	Adj:Mas+SG
haveuse	haveur	Adj:Fem+SG
haveuse	haveur	Nom:Fem+SG
haveuse	haveuse	Nom:Fem+SG
havi	havir	Ver:PPas
havi	havir	Ver:PPas+Mas+SG
havir	havir	Ver:Inf
havissant	havir	Ver:PPre
havissant	havir	Ver:PPre+Mas+SG
havrais	havrais	Adj:Mas+InvPL
havre	havre	Nom:Mas+SG
havresac	havresac	Nom:Mas+SG
havres	havre	Nom:Mas+PL
havrit	havrit	Nom:Mas+SG
hawaïen	hawaïen	Adj:Mas+SG
hawaiien	hawaiien	Adj:Mas+SG
hawaiienne	hawaiien	Adj:Fem+SG
hawaiienne	hawaiien	Nom:Fem+SG
hawaiiennes	hawaiien	Adj:Fem+PL
hawaiiennes	hawaiien	Nom:Fem+PL
hayon	hayon	Nom:Mas+SG
hayons	hayon	Nom:Mas+PL
heaume	heaume	Nom:Mas+SG
heaumes	heaume	Nom:Mas+PL
heaumier	heaumier	Nom:Mas+SG
hebdomadaire	hebdomadaire	Adj:InvGen+SG
hebdomadairement	hebdomadairement	Adv
hebdomadaires	hebdomadaire	Adj:InvGen+PL
hebdomadier	hebdomadier	Nom:Mas+SG
hébéphrène	hébéphrène	Adj:InvGen+SG
hébéphrénie	hébéphrénie	Nom:Fem+SG
hébéphrénique	hébéphrénique	Adj:InvGen+SG
hébéphrénique	hébéphrénique	Nom:InvGen+SG
hébergea	héberger	Ver:IPSim+SG+P3
hébergeaient	héberger	Ver:IImp+PL+P3
hébergeai	héberger	Ver:IPSim+SG+P1
hébergeais	héberger	Ver:IImp+SG+P1:IImp+SG+P2
hébergeait	héberger	Ver:IImp+SG+P3
hébergeâmes	héberger	Ver:IPSim+PL+P1
hébergeant	héberger	Ver:PPre
hébergeas	héberger	Ver:IPSim+SG+P2
hébergeasse	héberger	Ver:SImp+SG+P1
hébergeassent	héberger	Ver:SImp+PL+P3
hébergeasses	héberger	Ver:SImp+SG+P2
hébergeassiez	héberger	Ver:SImp+PL+P2
hébergeassions	héberger	Ver:SImp+PL+P1
hébergeâtes	héberger	Ver:IPSim+PL+P2
hébergeât	héberger	Ver:SImp+SG+P3
hébergée	héberger	Ver:PPas+Fem+SG
hébergées	héberger	Ver:PPas+Fem+PL
héberge	héberge	Nom:Fem+SG
héberge	héberger	Ver:IPre+SG+P1:IPre+SG+P3:SPre+SG+P1:SPre+SG+P3:ImPre+SG+P2
hébergé	héberger	Ver:PPas+Mas+SG
hébergement	hébergement	Nom:Mas+SG
hébergements	hébergement	Nom:Mas+PL
hébergent	héberger	Ver:IPre+PL+P3:SPre+PL+P3
hébergeons	héberger	Ver:IPre+PL+P1:ImPre+PL+P1
hébergera	héberger	Ver:IFut+SG+P3
hébergeraient	héberger	Ver:CPre+PL+P3
hébergerai	héberger	Ver:IFut+SG+P1
hébergerais	héberger	Ver:CPre+SG+P1:CPre+SG+P2
hébergerait	héberger	Ver:CPre+SG+P3
hébergeras	héberger	Ver:IFut+SG+P2
hébergèrent	héberger	Ver:IPSim+PL+P3
hébergerez	héberger	Ver:IFut+PL+P2
héberger	héberger	Ver:Inf
hébergeriez	héberger	Ver:CPre+PL+P2
hébergerions	héberger	Ver:CPre+PL+P1
hébergerons	héberger	Ver:IFut+PL+P1
hébergeront	héberger	Ver:IFut+PL+P3
héberges	héberge	Nom:Fem+PL
héberges	héberger	Ver:IPre+SG+P2:SPre+SG+P2
hébergés	héberger	Ver:PPas+Mas+PL
hébergez	héberger	Ver:IPre+PL+P2:ImPre+PL+P2
hébergiez	héberger	Ver:IImp+PL+P2:SPre+PL+P2
hébergions	héberger	Ver:IImp+PL+P1:SPre+PL+P1
hébertisme	hébertisme	Nom:Mas+SG
hébertiste	hébertiste	Adj:InvGen+SG
hébertiste	hébertiste	Nom:InvGen+SG
hébétaient	hébéter	Ver:IImp+PL+P3
hébétant	hébéter	Ver:PPre
hébétée	hébété	Adj:Fem+SG
hébétée	hébété	Nom:Fem+SG
hébétée	hébéter	Ver:PPas+Fem+SG
hébétées	hébété	Adj:Fem+PL
hébétées	hébété	Nom:Fem+PL
hébétées	hébéter	Ver:PPas+Fem+PL
hébété	hébété	Adj:Mas+SG
hébété	hébété	Nom:Mas+SG
hébété	hébéter	Ver:PPas+Mas+SG
hébétement	hébétement	Nom:Mas+SG
hébéter	hébéter	Ver:Inf
hébétés	hébété	Adj:Mas+PL
hébétés	hébété	Nom:Mas+PL
hébétés	hébéter	Ver:PPas+Mas+PL
hébétude	hébétude	Nom:Fem+SG
héboïdophrénie	héboïdophrénie	Nom:Fem+SG
hébraïque	hébraïque	Adj:InvGen+SG
hébraïque	hébreu	Adj:Fem+SG
hébraïques	hébraïque	Adj:InvGen+PL
hébraïques	hébreu	Adj:Fem+PL
hébraïsant	hébraïsant	Adj:Mas+SG
hébraïsant	hébraïsant	Nom:Mas+SG
hébraïsant	hébraïser	Ver:PPre
hébraïser	hébraïser	Ver:Inf
hébraïsme	hébraïsme	Nom:Mas+SG
hébraïste	hébraïste	Nom:InvGen+SG
hébreu	hébreu	Adj:Mas+SG
hébreu	hébreu	Nom:Mas+SG
hébreux	hébreu	Adj:Mas+PL
hécatombe	hécatombe	Nom:Fem+SG
hécatombes	hécatombe	Nom:Fem+PL
hectare	hectare	Nom:Mas+SG
hectares	hectare	Nom:Mas+PL
hectique	hectique	Adj:InvGen+SG
hectogramme	hectogramme	Nom:Mas+SG
hectogrammes	hectogramme	Nom:Mas+PL
hecto	hecto	Nom:Mas+SG
hectolitre	hectolitre	Nom:Mas+SG
hectolitres	hectolitre	Nom:Mas+PL
hectomètre	hectomètre	Nom:Mas+SG
hectométrique	hectométrique	Adj:InvGen+SG
hectowatt	hectowatt	Nom:Mas+SG
hédonisme	hédonisme	Nom:Mas+SG
hédoniste	hédoniste	Adj:InvGen+SG
hédonistique	hédonistique	Adj:InvGen+SG
hégélianisme	hégélianisme	Nom:Mas+SG
hégélien	hégélien	Adj:Mas+SG
hégémonie	hégémonie	Nom:Fem+SG
hégémonies	hégémonie	Nom:Fem+PL
hégémonique	hégémonique	Adj:InvGen+SG
hégémoniques	hégémonique	Adj:InvGen+PL
hégire	hégire	Nom:Fem+SG
hé	hé	Int
heiduque	heiduque	Nom:InvGen+SG
heimatlos	heimatlos	Adj:InvGen+SG:InvGen+PL
hein	hein	Int
héla	héler	Ver:IPSim+SG+P3
hélaient	héler	Ver:IImp+PL+P3
hélai	héler	Ver:IPSim+SG+P1
hélais	héler	Ver:IImp+SG+P1:IImp+SG+P2
hélait	héler	Ver:IImp+SG+P3
hélâmes	héler	Ver:IPSim+PL+P1
hélant	héler	Ver:PPre
hélas	hélas	Int
hélas	héler	Ver:IPSim+SG+P2
hélasse	héler	Ver:SImp+SG+P1
hélassent	héler	Ver:SImp+PL+P3
hélasses	héler	Ver:SImp+SG+P2
hélassiez	héler	Ver:SImp+PL+P2
hélassions	héler	Ver:SImp+PL+P1
hélâtes	héler	Ver:IPSim+PL+P2
hélât	héler	Ver:SImp+SG+P3
hélée	héler	Ver:PPas+Fem+SG
hélées	héler	Ver:PPas+Fem+PL
hèle	héler	Ver:IPre+SG+P1:IPre+SG+P3:SPre+SG+P1:SPre+SG+P3:ImPre+SG+P2
hélé	héler	Ver:PPas+Mas+SG
hèlent	héler	Ver:IPre+PL+P3:SPre+PL+P3
hélépole	hélépole	Nom:Fem+SG
hélera	héler	Ver:IFut+SG+P3
héleraient	héler	Ver:CPre+PL+P3
hélerai	héler	Ver:IFut+SG+P1
hélerais	héler	Ver:CPre+SG+P1:CPre+SG+P2
hélerait	héler	Ver:CPre+SG+P3
héleras	héler	Ver:IFut+SG+P2
hélèrent	héler	Ver:IPSim+PL+P3
hélerez	héler	Ver:IFut+PL+P2
héler	héler	Ver:Inf
héleriez	héler	Ver:CPre+PL+P2
hélerions	héler	Ver:CPre+PL+P1
hélerons	héler	Ver:IFut+PL+P1
héleront	héler	Ver:IFut+PL+P3
hèles	héler	Ver:IPre+SG+P2:SPre+SG+P2
hélés	héler	Ver:PPas+Mas+PL
hélez	héler	Ver:IPre+PL+P2:ImPre+PL+P2
hélianthe	hélianthe	Nom:Mas+SG
hélianthème	hélianthème	Nom:Mas+SG
hélianthes	hélianthe	Nom:Mas+PL
hélianthine	hélianthine	Nom:Fem+SG
héliaque	héliaque	Adj:InvGen+SG
héliaste	héliaste	Nom:Mas+SG
hélice	hélice	Nom:Fem+SG
hélices	hélice	Nom:Fem+PL
héliciculteur	héliciculteur	Nom:Mas+SG
héliciculture	héliciculture	Nom:Fem+SG
hélicoïdale	hélicoïdal	Adj:Fem+SG
hélicoïdales	hélicoïdal	Adj:Fem+PL
hélicoïdal	hélicoïdal	Adj:Mas+SG
hélicoïdaux	hélicoïdal	Adj:Mas+PL
hélicoïde	hélicoïde	Adj:InvGen+SG
hélicoïde	hélicoïde	Nom:Mas+SG
hélicon	hélicon	Nom:Mas+SG
hélicoptère	hélicoptère	Nom:Mas+SG
hélicoptères	hélicoptère	Nom:Mas+PL
héliez	héler	Ver:IImp+PL+P2:SPre+PL+P2
héligare	héligare	Nom:Fem+SG
héliocentrique	héliocentrique	Adj:InvGen+SG
héliochromie	héliochromie	Nom:Fem+SG
héliodore	héliodore	Nom:Mas+SG
héliographe	héliographe	Nom:Mas+SG
héliographie	héliographie	Nom:Fem+SG
héliograveur	héliograveur	Nom:Mas+SG
héliogravure	héliogravure	Nom:Fem+SG
héliomarin	héliomarin	Adj:Mas+SG
hélion	hélion	Nom:Mas+SG
hélions	héler	Ver:IImp+PL+P1:SPre+PL+P1
hélions	hélion	Nom:Mas+PL
héliostat	héliostat	Nom:Mas+SG
héliosynchrone	héliosynchrone	Adj:InvGen+SG
héliothérapie	héliothérapie	Nom:Fem+SG
héliotrope	héliotrope	Nom:Mas+SG
héliotropine	héliotropine	Nom:Fem+SG
héliotropisme	héliotropisme	Nom:Mas+SG
héliportage	héliportage	Nom:Mas+SG
héliportée	héliporté	Adj:Fem+SG
héliportée	héliporter	Ver:PPas+Fem+SG
héliportées	héliporté	Adj:Fem+PL
héliportées	héliporter	Ver:PPas+Fem+PL
héliporté	héliporté	Adj:Mas+SG
héliporté	héliporter	Ver:PPas+Mas+SG
héliportés	héliporté	Adj:Mas+PL
héliportés	héliporter	Ver:PPas+Mas+PL
héliport	héliport	Nom:Mas+SG
héliports	héliport	Nom:Mas+PL
hélitransporté	hélitransporté	Adj:Mas+SG
hélitreuillage	hélitreuillage	Nom:Mas+SG
hélium	hélium	Nom:Mas+SG
hélix	hélix	Nom:Mas+InvPL
helladique	helladique	Adj:InvGen+SG
hellébore	hellébore	Nom:Mas+SG
hellène	hellène	Adj:InvGen+SG
hellènes	hellène	Adj:InvGen+PL
hellènes	hellène	Nom:InvGen+PL
hellénique	hellénique	Adj:InvGen+SG
helléniques	hellénique	Adj:InvGen+PL
hellénisant	hellénisant	Adj:Mas+SG
hellénisant	hellénisant	Nom:Mas+SG
hellénisant	helléniser	Ver:PPre
hellénisation	hellénisation	Nom:Fem+SG
hellénisations	hellénisation	Nom:Fem+PL
hellénisé	helléniser	Ver:PPas+Mas+SG
helléniser	helléniser	Ver:Inf
hellénisme	hellénisme	Nom:Mas+SG
hellénismes	hellénisme	Nom:Mas+PL
helléniste	helléniste	Nom:InvGen+SG
hellénistes	helléniste	Nom:InvGen+PL
hellénistique	hellénistique	Adj:InvGen+SG
hello	hello	Int
helminthe	helminthe	Nom:Mas+SG
helminthiase	helminthiase	Nom:Fem+SG
helminthique	helminthique	Adj:InvGen+SG
hélobiale	hélobiale	Nom:Fem+SG
hélobiales	hélobiale	Nom:Fem+PL
hélodée	hélodée	Nom:Fem+SG
héloderme	héloderme	Nom:Mas+SG
hélons	héler	Ver:IPre+PL+P1:ImPre+PL+P1
helvelle	helvelle	Nom:Fem+SG
helvète	helvète	Adj:InvGen+SG
helvètes	helvète	Adj:InvGen+PL
helvétique	helvétique	Adj:InvGen+SG
helvétiques	helvétique	Adj:InvGen+PL
helvétisme	helvétisme	Nom:Mas+SG
helvétismes	helvétisme	Nom:Mas+PL
hémarthrose	hémarthrose	Nom:Fem+SG
hématémèse	hématémèse	Nom:Fem+SG
hématidrose	hématidrose	Nom:Fem+SG
hématie	hématie	Nom:Fem+SG
hématies	hématie	Nom:Fem+PL
hématimètre	hématimètre	Nom:Fem+SG
hématine	hématine	Nom:Fem+SG
hématique	hématique	Adj:InvGen+SG
hématite	hématite	Nom:Fem+SG
hématologie	hématologie	Nom:Fem+SG
hématologique	hématologique	Adj:InvGen+SG
hématologiste	hématologiste	Nom:InvGen+SG
hématologue	hématologue	Nom:InvGen+SG
hématome	hématome	Nom:Mas+SG
hématomes	hématome	Nom:Mas+PL
hématopoïèse	hématopoïèse	Nom:Fem+SG
hématopoïétique	hématopoïétique	Adj:InvGen+SG
hématose	hématose	Nom:Fem+SG
hématose	hématoser	Ver:IPre+SG+P1:IPre+SG+P3:SPre+SG+P1:SPre+SG+P3:ImPre+SG+P2
hématozoaire	hématozoaire	Nom:Mas+SG
hématurie	hématurie	Nom:Fem+SG
hématurique	hématurique	Adj:InvGen+SG
hématurique	hématurique	Nom:InvGen+SG
héméralope	héméralope	Adj:InvGen+SG
héméralopie	héméralopie	Nom:Fem+SG
hémérocalle	hémérocalle	Nom:Fem+SG
hem	hem	Int
hémialgie	hémialgie	Nom:Fem+SG
hémianopsie	hémianopsie	Nom:Fem+SG
hémicrânie	hémicrânie	Nom:Fem+SG
hémicycle	hémicycle	Nom:Mas+SG
hémicycles	hémicycle	Nom:Mas+PL
hémicylindrique	hémicylindrique	Adj:InvGen+SG
hémièdre	hémièdre	Adj:InvGen+SG
hémiédrie	hémiédrie	Nom:Fem+SG
hémiédrique	hémiédrique	Adj:InvGen+SG
hémine	hémine	Nom:Fem+SG
hémione	hémione	Nom:Mas+SG
hémiparésie	hémiparésie	Nom:Fem+SG
hémiplégie	hémiplégie	Nom:Fem+SG
hémiplégique	hémiplégique	Adj:InvGen+SG
hémiplégique	hémiplégique	Nom:InvGen+SG
hémiplégiques	hémiplégique	Adj:InvGen+PL
hémiplégiques	hémiplégique	Nom:InvGen+PL
hémisphère	hémisphère	Nom:Mas+SG
hémisphères	hémisphère	Nom:Mas+PL
hémisphérique	hémisphérique	Adj:InvGen+SG
hémisphériques	hémisphérique	Adj:InvGen+PL
hémistiche	hémistiche	Nom:Mas+SG
hémistiches	hémistiche	Nom:Mas+PL
hémitropie	hémitropie	Nom:Fem+SG
hémochromatose	hémochromatose	Nom:Fem+SG
hémoculture	hémoculture	Nom:Fem+SG
hémocyanine	hémocyanine	Nom:Fem+SG
hémodialyse	hémodialyse	Nom:Fem+SG
hémodialyse	hémodialyser	Ver:IPre+SG+P1:IPre+SG+P3:SPre+SG+P1:SPre+SG+P3:ImPre+SG+P2
hémodynamique	hémodynamique	Adj:InvGen+SG
hémodynamique	hémodynamique	Nom:Fem+SG
hémogénie	hémogénie	Nom:Fem+SG
hémoglobine	hémoglobine	Nom:Fem+SG
hémoglobinurie	hémoglobinurie	Nom:Fem+SG
hémogramme	hémogramme	Nom:Mas+SG
hémolyse	hémolyse	Nom:Fem+SG
hémolysine	hémolysine	Nom:Fem+SG
hémolytique	hémolytique	Adj:InvGen+SG
hémopathie	hémopathie	Nom:Fem+SG
hémophile	hémophile	Adj:InvGen+SG
hémophile	hémophile	Nom:InvGen+SG
hémophiles	hémophile	Adj:InvGen+PL
hémophiles	hémophile	Nom:InvGen+PL
hémophilie	hémophilie	Nom:Fem+SG
hémoptysie	hémoptysie	Nom:Fem+SG
hémoptysique	hémoptysique	Adj:InvGen+SG
hémorragie	hémorragie	Nom:Fem+SG
hémorragies	hémorragie	Nom:Fem+PL
hémorragique	hémorragique	Adj:InvGen+SG
hémorroïdaire	hémorroïdaire	Adj:InvGen+SG
hémorroïdale	hémorroïdal	Adj:Fem+SG
hémorroïdales	hémorroïdal	Adj:Fem+PL
hémorroïdal	hémorroïdal	Adj:Mas+SG
hémorroïdaux	hémorroïdal	Adj:Mas+PL
hémorroïde	hémorroïde	Nom:Fem+SG
hémorroïdes	hémorroïde	Nom:Fem+PL
hémostase	hémostase	Nom:Fem+SG
hémostases	hémostase	Nom:Fem+PL
hémostatique	hémostatique	Adj:InvGen+SG
hémostatique	hémostatique	Nom:Mas+SG
hémostatiques	hémostatique	Adj:InvGen+PL
hémostatiques	hémostatique	Nom:Mas+PL
hendécagone	hendécagone	Nom:Mas+SG
hendécasyllabe	hendécasyllabe	Adj:InvGen+SG
hendiadys	hendiadys	Nom:Mas+InvPL
henné	henné	Nom:Mas+SG
hennie	hennir	Ver:PPas+Fem+SG
hennies	hennir	Ver:PPas+Fem+PL
henni	hennir	Ver:PPas+Mas+SG
hennîmes	hennir	Ver:IPSim+PL+P1
hennin	hennin	Nom:Mas+SG
hennira	hennir	Ver:IFut+SG+P3
henniraient	hennir	Ver:CPre+PL+P3
hennirai	hennir	Ver:IFut+SG+P1
hennirais	hennir	Ver:CPre+SG+P1
hennirais	hennir	Ver:CPre+SG+P2
hennirait	hennir	Ver:CPre+SG+P3
henniras	hennir	Ver:IFut+SG+P2
hennirent	hennir	Ver:IPSim+PL+P3
hennirez	hennir	Ver:IFut+PL+P2
hennir	hennir	Ver:Inf
henniriez	hennir	Ver:CPre+PL+P2
hennirions	hennir	Ver:CPre+PL+P1
hennirons	hennir	Ver:IFut+PL+P1
henniront	hennir	Ver:IFut+PL+P3
	hennir	Ver:IPre+PL+P2
hennis	hennir	Ver:Imp+SG+P2
hennis	hennir	Ver:IPre+SG+P1
hennis	hennir	Ver:IPre+SG+P2
hennis	hennir	Ver:PPas+Mas+PL
hennis	hennir	Ver:IPSim+SG+P1
hennis	hennir	Ver:IPSim+SG+P2
hennissaient	hennir	Ver:IImp+PL+P3
hennissais	hennir	Ver:IImp+SG+P1
hennissais	hennir	Ver:IImp+SG+P2
hennissait	hennir	Ver:IImp+SG+P3
hennissant	hennir	Ver:PPre
hennissant	hennir	Ver:PPre
hennissant	hennir	Ver:PPre+Mas+SG
hennissant	hennissant	Adj:Mas+SG
hennissant	hennissant	Adj:Mas+SG
hennisse	hennir	Ver:SImp+SG+P1
hennisse	hennir	Ver:SPre+SG+P1
hennisse	hennir	Ver:SPre+SG+P3
hennissement	hennissement	Nom:Mas+SG
hennissements	hennissement	Nom:Mas+PL
hennissent	hennir	Ver:IPre+PL+P3
hennissent	hennir	Ver:SImp+PL+P3
hennissent	hennir	Ver:SPre+PL+P3
hennisses	hennir	Ver:SImp+SG+P2
hennisses	hennir	Ver:SPre+SG+P2
hennissiez	hennir	Ver:IImp+PL+P2
hennissiez	hennir	Ver:SImp+PL+P2
hennissiez	hennir	Ver:SPre+PL+P2
hennissions	hennir	Ver:IImp+PL+P1
hennissions	hennir	Ver:SImp+PL+P1
hennissions	hennir	Ver:SPre+PL+P1
hennissons	hennir	Ver:Imp+PL+P1
hennissons	hennir	Ver:IPre+PL+P1
hennîtes	hennir	Ver:IPSim+PL+P2
hennit	hennir	Ver:IPre+SG+P3
hennit	hennir	Ver:IPSim+SG+P3
hennît	hennir	Ver:SImp+SG+P3
hennuyer	hennuyer	Adj:Mas+SG
henry	henry	Nom:Mas+SG
héparine	héparine	Nom:Fem+SG
hépatalgie	hépatalgie	Nom:Fem+SG
hépatectomie	hépatectomie	Nom:Fem+SG
hépatique	hépatique	Adj:InvGen+SG
hépatique	hépatique	Nom:Fem+SG
hépatique	hépatique	Nom:InvGen+SG
hépatiques	hépatique	Adj:InvGen+PL
hépatiques	hépatique	Nom:Fem+PL
hépatiques	hépatique	Nom:InvGen+PL
hépatisation	hépatisation	Nom:Fem+SG
hépatisme	hépatisme	Nom:Mas+SG
hépatite	hépatite	Nom:Fem+SG
hépatites	hépatite	Nom:Fem+PL
hépatocèle	hépatocèle	Nom:Fem+SG
hépatologie	hépatologie	Nom:Fem+SG
hépatomégalie	hépatomégalie	Nom:Fem+SG
hépatonéphrite	hépatonéphrite	Nom:Fem+SG
hépatotomie	hépatotomie	Nom:Fem+SG
hépatotoxémie	hépatotoxémie	Nom:Fem+SG
hep	hep	Int
heptacorde	heptacorde	Adj:InvGen+SG
heptaèdre	heptaèdre	Nom:Mas+SG
heptagonale	heptagonal	Adj:Fem+SG
heptagonales	heptagonal	Adj:Fem+PL
heptagonal	heptagonal	Adj:Mas+SG
heptagonaux	heptagonal	Adj:Mas+PL
heptagone	heptagone	Nom:Mas+SG
heptamètre	heptamètre	Nom:Mas+SG
heptamètres	heptamètre	Nom:Mas+PL
héraldique	héraldique	Adj:InvGen+SG
héraldiques	héraldique	Adj:InvGen+PL
héraldiques	héraldique	Nom:Fem+PL
héraldiste	héraldiste	Nom:InvGen+SG
héraldistes	héraldiste	Nom:InvGen+PL
héraut	héraut	Nom:Mas+SG
hérauts	héraut	Nom:Mas+PL
herbacée	herbacé	Adj:Fem+SG
herbacées	herbacé	Adj:Fem+PL
herbacé	herbacé	Adj:Mas+SG
herbacés	herbacé	Adj:Mas+PL
herbageant	herbager	Ver:PPre
herbage	herbage	Nom:Mas+SG
herbage	herbager	Ver:IPre+SG+P1:IPre+SG+P3:SPre+SG+P1:SPre+SG+P3:ImPre+SG+P2
herbagé	herbager	Ver:PPas+Mas+SG
herbagent	herbager	Ver:IPre+PL+P3:SPre+PL+P3
herbagera	herbager	Ver:IFut+SG+P3
herbageraient	herbager	Ver:CPre+PL+P3
herbagerai	herbager	Ver:IFut+SG+P1
herbagerais	herbager	Ver:CPre+SG+P1:CPre+SG+P2
herbagerait	herbager	Ver:CPre+SG+P3
herbageras	herbager	Ver:IFut+SG+P2
herbagère	herbagère	Nom:Fem+SG
herbagère	herbager	Nom:Fem+SG
herbagères	herbagère	Nom:Fem+PL
herbagères	herbager	Nom:Fem+PL
herbagerez	herbager	Ver:IFut+PL+P2
herbager	herbager	Nom:Mas+SG
herbager	herbager	Ver:Inf
herbageriez	herbager	Ver:CPre+PL+P2
herbagerions	herbager	Ver:CPre+PL+P1
herbagerons	herbager	Ver:IFut+PL+P1
herbageront	herbager	Ver:IFut+PL+P3
herbages	herbage	Nom:Mas+PL
herbages	herbager	Ver:IPre+SG+P2:SPre+SG+P2
herba	herber	Ver:IPSim+SG+P3
herbaient	herber	Ver:IImp+PL+P3
herbai	herber	Ver:IPSim+SG+P1
herbais	herber	Ver:IImp+SG+P1:IImp+SG+P2
herbait	herber	Ver:IImp+SG+P3
herbâmes	herber	Ver:IPSim+PL+P1
herbant	herber	Ver:PPre
herbas	herber	Ver:IPSim+SG+P2
herbasse	herber	Ver:SImp+SG+P1
herbassent	herber	Ver:SImp+PL+P3
herbasses	herber	Ver:SImp+SG+P2
herbassiez	herber	Ver:SImp+PL+P2
herbassions	herber	Ver:SImp+PL+P1
herbâtes	herber	Ver:IPSim+PL+P2
herbât	herber	Ver:SImp+SG+P3
herbée	herber	Ver:PPas+Fem+SG
herbées	herber	Ver:PPas+Fem+PL
herbe	herbe	Nom:Fem+SG
herbe	herber	Ver:IPre+SG+P1:IPre+SG+P3:SPre+SG+P1:SPre+SG+P3:ImPre+SG+P2
herbé	herber	Ver:PPas+Mas+SG
herbent	herber	Ver:IPre+PL+P3:SPre+PL+P3
herbera	herber	Ver:IFut+SG+P3
herberaient	herber	Ver:CPre+PL+P3
herberai	herber	Ver:IFut+SG+P1
herberais	herber	Ver:CPre+SG+P1:CPre+SG+P2
herberait	herber	Ver:CPre+SG+P3
herberas	herber	Ver:IFut+SG+P2
herbèrent	herber	Ver:IPSim+PL+P3
herberez	herber	Ver:IFut+PL+P2
herber	herber	Ver:Inf
herberie	herberie	Nom:Fem+SG
herberiez	herber	Ver:CPre+PL+P2
herberions	herber	Ver:CPre+PL+P1
herberons	herber	Ver:IFut+PL+P1
herberont	herber	Ver:IFut+PL+P3
herbes	herbe	Nom:Fem+PL
herbes	herber	Ver:IPre+SG+P2:SPre+SG+P2
herbés	herber	Ver:PPas+Mas+PL
herbes	herbes	Nom:Fem+PL
herbette	herbette	Nom:Fem+SG
herbeuse	herbeux	Adj:Fem+SG
herbeuses	herbeux	Adj:Fem+PL
herbeux	herbeux	Adj:Mas+InvPL
herbez	herber	Ver:IPre+PL+P2:ImPre+PL+P2
herbicide	herbicide	Adj:InvGen+SG
herbicide	herbicide	Nom:Mas+SG
herbicides	herbicide	Adj:InvGen+PL
herbicides	herbicide	Nom:Mas+PL
herbier	herbier	Nom:Mas+SG
herbiers	herbier	Nom:Mas+PL
herbiez	herber	Ver:IImp+PL+P2:SPre+PL+P2
herbions	herber	Ver:IImp+PL+P1:SPre+PL+P1
herbivore	herbivore	Adj:InvGen+SG
herbivores	herbivore	Adj:InvGen+PL
herbons	herber	Ver:IPre+PL+P1:ImPre+PL+P1
herborisa	herboriser	Ver:IPSim+SG+P3
herborisaient	herboriser	Ver:IImp+PL+P3
herborisai	herboriser	Ver:IPSim+SG+P1
herborisais	herboriser	Ver:IImp+SG+P1:IImp+SG+P2
herborisait	herboriser	Ver:IImp+SG+P3
herborisâmes	herboriser	Ver:IPSim+PL+P1
herborisant	herboriser	Ver:PPre
herborisas	herboriser	Ver:IPSim+SG+P2
herborisasse	herboriser	Ver:SImp+SG+P1
herborisassent	herboriser	Ver:SImp+PL+P3
herborisasses	herboriser	Ver:SImp+SG+P2
herborisassiez	herboriser	Ver:SImp+PL+P2
herborisassions	herboriser	Ver:SImp+PL+P1
herborisâtes	herboriser	Ver:IPSim+PL+P2
herborisateur	herborisateur	Nom:Mas+SG
herborisât	herboriser	Ver:SImp+SG+P3
herborisation	herborisation	Nom:Fem+SG
herborisations	herborisation	Nom:Fem+PL
herborisé	herborisé	Adj:Mas+SG
herborise	herboriser	Ver:IPre+SG+P1:IPre+SG+P3:SPre+SG+P1:SPre+SG+P3:ImPre+SG+P2
herborisé	herboriser	Ver:PPas+Mas+SG
herborisent	herboriser	Ver:IPre+PL+P3:SPre+PL+P3
herborisèrent	herboriser	Ver:IPSim+PL+P3
herboriser	herboriser	Ver:Inf
herborises	herboriser	Ver:IPre+SG+P2:SPre+SG+P2
herborisez	herboriser	Ver:IPre+PL+P2:ImPre+PL+P2
herborisiez	herboriser	Ver:IImp+PL+P2:SPre+PL+P2
herborisions	herboriser	Ver:IImp+PL+P1:SPre+PL+P1
herborisons	herboriser	Ver:IPre+PL+P1:ImPre+PL+P1
herboriste	herboriste	Nom:InvGen+SG
herboristerie	herboristerie	Nom:Fem+SG
herboristeries	herboristerie	Nom:Fem+PL
herboristes	herboriste	Nom:InvGen+PL
herbue	herbu	Adj:Fem+SG
herbue	herbue	Nom:Fem+SG
herbues	herbu	Adj:Fem+PL
herbues	herbue	Nom:Fem+PL
herbu	herbu	Adj:Mas+SG
herbu	herbu	Nom:Mas+SG
herchage	herchage	Nom:Mas+SG
herchages	herchage	Nom:Mas+PL
hercha	hercher	Ver:IPSim+SG+P3
herchaient	hercher	Ver:IImp+PL+P3
herchai	hercher	Ver:IPSim+SG+P1
herchais	hercher	Ver:IImp+SG+P1:IImp+SG+P2
herchait	hercher	Ver:IImp+SG+P3
herchâmes	hercher	Ver:IPSim+PL+P1
herchant	hercher	Ver:PPre
herchants	hercher	Ver:PPre+Mas+PL
herchas	hercher	Ver:IPSim+SG+P2
herchasse	hercher	Ver:SImp+SG+P1
herchassent	hercher	Ver:SImp+PL+P3
herchasses	hercher	Ver:SImp+SG+P2
herchassiez	hercher	Ver:SImp+PL+P2
herchassions	hercher	Ver:SImp+PL+P1
herchâtes	hercher	Ver:IPSim+PL+P2
herchât	hercher	Ver:SImp+SG+P3
herche	hercher	Ver:IPre+SG+P1:IPre+SG+P3:SPre+SG+P1:SPre+SG+P3:ImPre+SG+P2
herché	hercher	Ver:PPas+Mas+SG
herchent	hercher	Ver:IPre+PL+P3:SPre+PL+P3
herchèrent	hercher	Ver:IPSim+PL+P3
hercher	hercher	Ver:Inf
herches	hercher	Ver:IPre+SG+P2:SPre+SG+P2
hercheur	hercheur	Nom:Mas+SG
hercheurs	hercheur	Nom:Mas+PL
hercheuse	hercheur	Nom:Fem+SG
hercheuses	hercheur	Nom:Fem+PL
herchez	hercher	Ver:IPre+PL+P2:ImPre+PL+P2
herchiez	hercher	Ver:IImp+PL+P2:SPre+PL+P2
herchions	hercher	Ver:IImp+PL+P1:SPre+PL+P1
herchons	hercher	Ver:IPre+PL+P1:ImPre+PL+P1
herculéen	herculéen	Adj:Mas+SG
herculéenne	herculéen	Adj:Fem+SG
herculéennes	herculéen	Adj:Fem+PL
herculéens	herculéen	Adj:Mas+PL
hercule	hercule	Nom:Mas+SG
hercules	hercule	Nom:Mas+PL
hercynien	hercynien	Adj:Mas+SG
hercynienne	hercynien	Adj:Fem+SG
hercyniennes	hercynien	Adj:Fem+PL
hercyniens	hercynien	Adj:Mas+PL
hercyniens	hercynien	Nom:Mas+PL
herd-book	herd-book	Nom:Mas+SG
héréditaire	héréditaire	Adj:InvGen+SG
héréditairement	héréditairement	Adv
héréditaires	héréditaire	Adj:InvGen+PL
hérédité	hérédité	Nom:Fem+SG
hérédosyphilis	hérédosyphilis	Nom:Fem+InvPL
hère	hère	Nom:Mas+SG
hères	hère	Nom:Mas+PL
hérésiarque	hérésiarque	Nom:InvGen+SG
hérésie	hérésie	Nom:Fem+SG
hérésies	hérésie	Nom:Fem+PL
hérétique	hérétique	Adj:InvGen+SG
hérétiques	hérétique	Adj:InvGen+PL
hérissa	hérisser	Ver:IPSim+SG+P3
hérissaient	hérisser	Ver:IImp+PL+P3
hérissai	hérisser	Ver:IPSim+SG+P1
hérissais	hérisser	Ver:IImp+SG+P1:IImp+SG+P2
hérissait	hérisser	Ver:IImp+SG+P3
hérissâmes	hérisser	Ver:IPSim+PL+P1
hérissant	hérisser	Ver:PPre
hérissas	hérisser	Ver:IPSim+SG+P2
hérissasse	hérisser	Ver:SImp+SG+P1
hérissassent	hérisser	Ver:SImp+PL+P3
hérissasses	hérisser	Ver:SImp+SG+P2
hérissassiez	hérisser	Ver:SImp+PL+P2
hérissassions	hérisser	Ver:SImp+PL+P1
hérissâtes	hérisser	Ver:IPSim+PL+P2
hérissât	hérisser	Ver:SImp+SG+P3
hérissée	hérissé	Adj:Fem+SG
hérissée	hérisser	Ver:PPas+Fem+SG
hérissées	hérissé	Adj:Fem+PL
hérissées	hérisser	Ver:PPas+Fem+PL
hérissé	hérissé	Adj:Mas+SG
hérisse	hérisser	Ver:Imp+SG+P2
hérisse	hérisser	Ver:IPre+SG+P1
hérisse	hérisser	Ver:IPre+SG+P3
hérissé	hérisser	Ver:PPas+Mas+SG
hérisse	hérisser	Ver:SPre+SG+P1
hérisse	hérisser	Ver:SPre+SG+P3
hérissement	hérissement	Nom:Mas+SG
hérissent	hérisser	Ver:IPre+PL+P3
hérissent	hérisser	Ver:SPre+PL+P3
hérissera	hérisser	Ver:IFut+SG+P3
hérisseraient	hérisser	Ver:CPre+PL+P3
hérisserai	hérisser	Ver:IFut+SG+P1
hérisserais	hérisser	Ver:CPre+SG+P1:CPre+SG+P2
hérisserait	hérisser	Ver:CPre+SG+P3
hérisseras	hérisser	Ver:IFut+SG+P2
hérissèrent	hérisser	Ver:IPSim+PL+P3
hérisserez	hérisser	Ver:IFut+PL+P2
hérisser	hérisser	Ver:Inf
hérisseriez	hérisser	Ver:CPre+PL+P2
hérisserions	hérisser	Ver:CPre+PL+P1
hérisserons	hérisser	Ver:IFut+PL+P1
hérisseront	hérisser	Ver:IFut+PL+P3
hérissés	hérissé	Adj:Mas+PL
hérisses	hérisser	Ver:IPre+SG+P2
hérissés	hérisser	Ver:PPas+Mas+PL
hérisses	hérisser	Ver:SPre+SG+P2
hérissez	hérisser	Ver:IPre+PL+P2:ImPre+PL+P2
hérissiez	hérisser	Ver:IImp+PL+P2:SPre+PL+P2
hérissions	hérisser	Ver:IImp+PL+P1:SPre+PL+P1
hérisson	hérisson	Nom:Mas+SG
hérissonna	hérissonner	Ver:IPSim+SG+P3
hérissonnaient	hérissonner	Ver:IImp+PL+P3
hérissonnai	hérissonner	Ver:IPSim+SG+P1
hérissonnais	hérissonner	Ver:IImp+SG+P1:IImp+SG+P2
hérissonnait	hérissonner	Ver:IImp+SG+P3
hérissonnâmes	hérissonner	Ver:IPSim+PL+P1
hérissonnant	hérissonner	Ver:PPre
hérissonnas	hérissonner	Ver:IPSim+SG+P2
hérissonnasse	hérissonner	Ver:SImp+SG+P1
hérissonnassent	hérissonner	Ver:SImp+PL+P3
hérissonnasses	hérissonner	Ver:SImp+SG+P2
hérissonnassiez	hérissonner	Ver:SImp+PL+P2
hérissonnassions	hérissonner	Ver:SImp+PL+P1
hérissonnâtes	hérissonner	Ver:IPSim+PL+P2
hérissonnât	hérissonner	Ver:SImp+SG+P3
hérissonne	hérissonne	Adj:Fem+SG
hérissonne	hérissonne	Nom:Fem+SG
hérissonne	hérissonner	Ver:IPre+SG+P1:IPre+SG+P3:SPre+SG+P1:SPre+SG+P3:ImPre+SG+P2
hérissonné	hérissonner	Ver:PPas+Mas+SG
hérissonnent	hérissonner	Ver:IPre+PL+P3:SPre+PL+P3
hérissonnèrent	hérissonner	Ver:IPSim+PL+P3
hérissonner	hérissonner	Ver:Inf
hérissonnes	hérissonne	Adj:Fem+PL
hérissonnes	hérissonne	Nom:Fem+PL
hérissonnes	hérissonner	Ver:IPre+SG+P2:SPre+SG+P2
hérissonnez	hérissonner	Ver:IPre+PL+P2:ImPre+PL+P2
hérissonniez	hérissonner	Ver:IImp+PL+P2:SPre+PL+P2
hérissonnions	hérissonner	Ver:IImp+PL+P1:SPre+PL+P1
hérissonnons	hérissonner	Ver:IPre+PL+P1:ImPre+PL+P1
hérissons	hérisser	Ver:IPre+PL+P1:ImPre+PL+P1
hérissons	hérisson	Nom:Mas+PL
héritage	héritage	Nom:Mas+SG
héritages	héritage	Nom:Mas+PL
hérita	hériter	Ver:IPSim+SG+P3
héritaient	hériter	Ver:IImp+PL+P3
héritai	hériter	Ver:IPSim+SG+P1
héritais	hériter	Ver:IImp+SG+P1:IImp+SG+P2
héritait	hériter	Ver:IImp+SG+P3
héritâmes	hériter	Ver:IPSim+PL+P1
héritant	hériter	Ver:PPre
héritas	hériter	Ver:IPSim+SG+P2
héritasse	hériter	Ver:SImp+SG+P1
héritassent	hériter	Ver:SImp+PL+P3
héritasses	hériter	Ver:SImp+SG+P2
héritassiez	hériter	Ver:SImp+PL+P2
héritassions	hériter	Ver:SImp+PL+P1
héritâtes	hériter	Ver:IPSim+PL+P2
héritât	hériter	Ver:SImp+SG+P3
héritée	hériter	Ver:PPas+Fem+SG
héritées	hériter	Ver:PPas+Fem+PL
hérite	hériter	Ver:IPre+SG+P1:IPre+SG+P3:SPre+SG+P1:SPre+SG+P3:ImPre+SG+P2
hérité	hériter	Ver:PPas+Mas+SG
héritent	hériter	Ver:IPre+PL+P3:SPre+PL+P3
héritera	hériter	Ver:IFut+SG+P3
hériteraient	hériter	Ver:CPre+PL+P3
hériterai	hériter	Ver:IFut+SG+P1
hériterais	hériter	Ver:CPre+SG+P1:CPre+SG+P2
hériterait	hériter	Ver:CPre+SG+P3
hériteras	hériter	Ver:IFut+SG+P2
héritèrent	hériter	Ver:IPSim+PL+P3
hériterez	hériter	Ver:IFut+PL+P2
hériter	hériter	Ver:Inf
hériteriez	hériter	Ver:CPre+PL+P2
hériterions	hériter	Ver:CPre+PL+P1
hériterons	hériter	Ver:IFut+PL+P1
hériteront	hériter	Ver:IFut+PL+P3
hérites	hériter	Ver:IPre+SG+P2:SPre+SG+P2
hérités	hériter	Ver:PPas+Mas+PL
héritez	hériter	Ver:IPre+PL+P2:ImPre+PL+P2
héritière	héritier	Adj:Fem+SG
héritière	héritier	Nom:Fem+SG
héritières	héritier	Adj:Fem+PL
héritières	héritier	Nom:Fem+PL
héritier	héritier	Adj:Mas+SG
héritier	héritier	Nom:Mas+SG
héritiers	héritier	Adj:Mas+PL
héritiers	héritier	Nom:Mas+PL
héritiez	hériter	Ver:IImp+PL+P2:SPre+PL+P2
héritions	hériter	Ver:IImp+PL+P1:SPre+PL+P1
héritons	hériter	Ver:IPre+PL+P1:ImPre+PL+P1
hermandad	hermandad	Nom:Fem+SG
hermaphrodisme	hermaphrodisme	Nom:Mas+SG
hermaphrodite	hermaphrodite	Adj:InvGen+SG
hermaphrodite	hermaphrodite	Nom:InvGen+SG
hermaphrodites	hermaphrodite	Adj:InvGen+PL
hermaphrodites	hermaphrodite	Nom:InvGen+PL
herméneutique	herméneutique	Adj:InvGen+SG
herméneutique	herméneutique	Nom:Fem+SG
herméneutiques	herméneutique	Adj:InvGen+PL
herméneutiques	herméneutique	Nom:Fem+PL
hermès	hermès	Nom:Mas+InvPL
herméticité	herméticité	Nom:Fem+SG
herméticités	herméticité	Nom:Fem+PL
hermétique	hermétique	Adj:InvGen+SG
hermétiquement	hermétiquement	Adv
hermétiques	hermétique	Adj:InvGen+PL
hermétisme	hermétisme	Nom:Mas+SG
hermine	hermine	Nom:Fem+SG
hermines	hermine	Nom:Fem+PL
herminette	herminette	Nom:Fem+SG
herniaire	herniaire	Adj:InvGen+SG
herniaires	herniaire	Adj:InvGen+PL
herniée	hernié	Adj:Fem+SG
herniées	hernié	Adj:Fem+PL
hernié	hernié	Adj:Mas+SG
hernie	hernie	Nom:Fem+SG
hernies	hernie	Nom:Fem+PL
hernieuse	hernieux	Adj:Fem+SG
hernieuse	hernieux	Nom:Fem+SG
hernieuses	hernieux	Adj:Fem+PL
hernieuses	hernieux	Nom:Fem+PL
hernieux	hernieux	Adj:Mas+InvPL
hernieux	hernieux	Nom:Mas+InvPL
héroïcité	héroïcité	Nom:Fem+SG
héroïde	héroïde	Nom:Fem+SG
héroïne	héroïne	Nom:Fem+SG
héroïne	héros	Nom:Fem+SG
héroïnes	héroïne	Nom:Fem+PL
héroïnes	héros	Nom:Fem+PL
héroïnomane	héroïnomane	Adj:InvGen+SG
héroïnomane	héroïnomane	Nom:InvGen+SG
héroïnomanes	héroïnomane	Nom:InvGen+PL
héroïque	héroïque	Adj:InvGen+SG
héroïquement	héroïquement	Adv
héroïques	héroïque	Adj:InvGen+PL
héroïsme	héroïsme	Nom:Mas+SG
héroï-comique	héroï-comique	Adj:InvGen+SG
héroï-comiques	héroï-comique	Adj:InvGen+PL
héron	héron	Nom:Mas+SG
héronneau	héronneau	Nom:Mas+SG
héronneaux	héronneau	Nom:Mas+PL
héronnière	héronnier	Adj:Fem+SG
héronnière	héronnière	Nom:Fem+SG
héronnières	héronnier	Adj:Fem+PL
héronnières	héronnière	Nom:Fem+PL
hérons	héron	Nom:Mas+PL
héros	héros	Nom:Mas+InvPL
herpe	herpe	Nom:Fem+SG
herpès	herpès	Nom:Mas+InvPL
herpétique	herpétique	Adj:InvGen+SG
herpétiques	herpétique	Adj:InvGen+PL
herpétologie	herpétologie	Nom:Fem+SG
herpétologies	herpétologie	Nom:Fem+PL
hersage	hersage	Nom:Mas+SG
hersages	hersage	Nom:Mas+PL
hersa	herser	Ver:IPSim+SG+P3
hersaient	herser	Ver:IImp+PL+P3
hersai	herser	Ver:IPSim+SG+P1
hersais	herser	Ver:IImp+SG+P1:IImp+SG+P2
hersait	herser	Ver:IImp+SG+P3
hersâmes	herser	Ver:IPSim+PL+P1
hersant	herser	Ver:PPre
hersas	herser	Ver:IPSim+SG+P2
hersasse	herser	Ver:SImp+SG+P1
hersassent	herser	Ver:SImp+PL+P3
hersasses	herser	Ver:SImp+SG+P2
hersassiez	herser	Ver:SImp+PL+P2
hersassions	herser	Ver:SImp+PL+P1
hersâtes	herser	Ver:IPSim+PL+P2
hersât	herser	Ver:SImp+SG+P3
herschage	herschage	Nom:Mas+SG
herschages	herschage	Nom:Mas+PL
herscha	herscher	Ver:IPSim+SG+P3
herschaient	herscher	Ver:IImp+PL+P3
herschai	herscher	Ver:IPSim+SG+P1
herschais	herscher	Ver:IImp+SG+P1:IImp+SG+P2
herschait	herscher	Ver:IImp+SG+P3
herschâmes	herscher	Ver:IPSim+PL+P1
herschant	herscher	Ver:PPre
herschas	herscher	Ver:IPSim+SG+P2
herschasse	herscher	Ver:SImp+SG+P1
herschassent	herscher	Ver:SImp+PL+P3
herschasses	herscher	Ver:SImp+SG+P2
herschassiez	herscher	Ver:SImp+PL+P2
herschassions	herscher	Ver:SImp+PL+P1
herschâtes	herscher	Ver:IPSim+PL+P2
herschât	herscher	Ver:SImp+SG+P3
hersche	herscher	Ver:IPre+SG+P1:IPre+SG+P3:SPre+SG+P1:SPre+SG+P3:ImPre+SG+P2
hersché	herscher	Ver:PPas+Mas+SG
herschent	herscher	Ver:IPre+PL+P3:SPre+PL+P3
herschèrent	herscher	Ver:IPSim+PL+P3
herscher	herscher	Ver:Inf
hersches	herscher	Ver:IPre+SG+P2:SPre+SG+P2
herscheur	herscheur	Nom:Mas+SG
herscheuse	herscheur	Nom:Fem+SG
herschez	herscher	Ver:IPre+PL+P2:ImPre+PL+P2
herschiez	herscher	Ver:IImp+PL+P2:SPre+PL+P2
herschions	herscher	Ver:IImp+PL+P1:SPre+PL+P1
herschons	herscher	Ver:IPre+PL+P1:ImPre+PL+P1
hersé	hersé	Adj:Mas+SG
herse	herse	Nom:Fem+SG
herse	herser	Ver:IPre+SG+P1:IPre+SG+P3:SPre+SG+P1:SPre+SG+P3:ImPre+SG+P2
hersé	herser	Ver:PPas+Mas+SG
hersent	herser	Ver:IPre+PL+P3:SPre+PL+P3
hersera	herser	Ver:IFut+SG+P3
herseraient	herser	Ver:CPre+PL+P3
herserai	herser	Ver:IFut+SG+P1
herserais	herser	Ver:CPre+SG+P1:CPre+SG+P2
herserait	herser	Ver:CPre+SG+P3
herseras	herser	Ver:IFut+SG+P2
hersèrent	herser	Ver:IPSim+PL+P3
herserez	herser	Ver:IFut+PL+P2
herser	herser	Ver:Inf
herseriez	herser	Ver:CPre+PL+P2
herserions	herser	Ver:CPre+PL+P1
herserons	herser	Ver:IFut+PL+P1
herseront	herser	Ver:IFut+PL+P3
herses	herse	Nom:Fem+PL
herses	herser	Ver:IPre+SG+P2:SPre+SG+P2
herseur	herseur	Adj:Mas+SG
herseur	herseur	Nom:Mas+SG
hersez	herser	Ver:IPre+PL+P2:ImPre+PL+P2
hersiez	herser	Ver:IImp+PL+P2:SPre+PL+P2
hersions	herser	Ver:IImp+PL+P1:SPre+PL+P1
hersons	herser	Ver:IPre+PL+P1:ImPre+PL+P1
hertz	hertz	Nom:Mas+InvPL
hertzien	hertzien	Adj:Mas+SG
hertzienne	hertzien	Adj:Fem+SG
hertziennes	hertzien	Adj:Fem+PL
hésita	hésiter	Ver:IPSim+SG+P3
hésitaient	hésiter	Ver:IImp+PL+P3
hésitai	hésiter	Ver:IPSim+SG+P1
hésitais	hésiter	Ver:IImp+SG+P1:IImp+SG+P2
hésitait	hésiter	Ver:IImp+SG+P3
hésitâmes	hésiter	Ver:IPSim+PL+P1
hésitante	hésitant	Adj:Fem+SG
hésitante	hésitant	Nom:Fem+SG
hésitantes	hésitant	Adj:Fem+PL
hésitantes	hésitant	Nom:Fem+PL
hésitant	hésitant	Adj:Mas+SG
hésitant	hésitant	Nom:Mas+SG
hésitant	hésiter	Ver:PPre
hésitants	hésitant	Adj:Mas+PL
hésitants	hésitant	Nom:Mas+PL
hésitas	hésiter	Ver:IPSim+SG+P2
hésitasse	hésiter	Ver:SImp+SG+P1
hésitassent	hésiter	Ver:SImp+PL+P3
hésitasses	hésiter	Ver:SImp+SG+P2
hésitassiez	hésiter	Ver:SImp+PL+P2
hésitassions	hésiter	Ver:SImp+PL+P1
hésitâtes	hésiter	Ver:IPSim+PL+P2
hésitât	hésiter	Ver:SImp+SG+P3
hésitation	hésitation	Nom:Fem+SG
hésitations	hésitation	Nom:Fem+PL
hésite	hésiter	Ver:IPre+SG+P1:IPre+SG+P3:SPre+SG+P1:SPre+SG+P3:ImPre+SG+P2
hésité	hésiter	Ver:PPas+Mas+SG
hésitent	hésiter	Ver:IPre+PL+P3:SPre+PL+P3
hésitera	hésiter	Ver:IFut+SG+P3
hésiteraient	hésiter	Ver:CPre+PL+P3
hésiterai	hésiter	Ver:IFut+SG+P1
hésiterais	hésiter	Ver:CPre+SG+P1:CPre+SG+P2
hésiterait	hésiter	Ver:CPre+SG+P3
hésiteras	hésiter	Ver:IFut+SG+P2
hésitèrent	hésiter	Ver:IPSim+PL+P3
hésiterez	hésiter	Ver:IFut+PL+P2
hésiter	hésiter	Ver:Inf
hésiteriez	hésiter	Ver:CPre+PL+P2
hésiterions	hésiter	Ver:CPre+PL+P1
hésiterons	hésiter	Ver:IFut+PL+P1
hésiteront	hésiter	Ver:IFut+PL+P3
hésites	hésiter	Ver:IPre+SG+P2:SPre+SG+P2
hésitez	hésiter	Ver:IPre+PL+P2:ImPre+PL+P2
hésitiez	hésiter	Ver:IImp+PL+P2:SPre+PL+P2
hésitions	hésiter	Ver:IImp+PL+P1:SPre+PL+P1
hésitons	hésiter	Ver:IPre+PL+P1:ImPre+PL+P1
hésychasme	hésychasme	Nom:Mas+SG
hésychasmes	hésychasme	Nom:Mas+PL
hétaïre	hétaïre	Nom:Fem+SG
hétaïres	hétaïre	Nom:Fem+PL
hétairie	hétairie	Nom:Fem+SG
hétairies	hétairie	Nom:Fem+PL
hétérie	hétérie	Nom:Fem+SG
hétérocentrique	hétérocentrique	Adj:InvGen+SG
hétérocerque	hétérocerque	Adj:InvGen+SG
hétérocerques	hétérocerque	Adj:InvGen+PL
hétérochromosome	hétérochromosome	Nom:Mas+SG
hétérochromosomes	hétérochromosome	Nom:Mas+PL
hétéroclite	hétéroclite	Adj:InvGen+SG
hétéroclites	hétéroclite	Adj:InvGen+PL
hétérocyclique	hétérocyclique	Adj:InvGen+SG
hétérocycliques	hétérocyclique	Adj:InvGen+PL
hétérodoxe	hétérodoxe	Adj:InvGen+SG
hétérodoxe	hétérodoxe	Nom:InvGen+SG
hétérodoxes	hétérodoxe	Adj:InvGen+PL
hétérodoxes	hétérodoxe	Nom:InvGen+PL
hétérodoxie	hétérodoxie	Nom:Fem+SG
hétérodoxies	hétérodoxie	Nom:Fem+PL
hétérodyne	hétérodyne	Adj:InvGen+SG
hétérodyne	hétérodyne	Nom:Fem+SG
hétérodynes	hétérodyne	Adj:InvGen+PL
hétérodynes	hétérodyne	Nom:Fem+PL
hétérogamie	hétérogamie	Nom:Fem+SG
hétérogamies	hétérogamie	Nom:Fem+PL
hétérogène	hétérogène	Adj:InvGen+SG
hétérogénéité	hétérogénéité	Nom:Fem+SG
hétérogénéités	hétérogénéité	Nom:Fem+PL
hétérogènes	hétérogène	Adj:InvGen+PL
hétérogénie	hétérogénie	Nom:Fem+SG
hétérogreffe	hétérogreffe	Nom:Fem+SG
hétérogreffes	hétérogreffe	Nom:Fem+PL
hétérologique	hétérologique	Adj:InvGen+SG
hétérologue	hétérologue	Adj:InvGen+SG
hétérométabole	hétérométabole	Adj:InvGen+SG
hétérométaboles	hétérométabole	Adj:InvGen+PL
hétéromorphe	hétéromorphe	Adj:InvGen+SG
hétéromorphes	hétéromorphe	Adj:InvGen+PL
hétéromorphie	hétéromorphie	Nom:Fem+SG
hétéromorphies	hétéromorphie	Nom:Fem+PL
hétéromorphisme	hétéromorphisme	Nom:Mas+SG
hétéromorphismes	hétéromorphisme	Nom:Mas+PL
hétérosexualité	hétérosexualité	Nom:Fem+SG
hétérosexuel	hétérosexuel	Adj:Mas+SG
hétérosexuel	hétérosexuel	Nom:Mas+SG
hétérosexuelle	hétérosexuel	Adj:Fem+SG
hétérosexuelle	hétérosexuel	Nom:Fem+SG
hétérosexuelles	hétérosexuel	Adj:Fem+PL
hétérosexuelles	hétérosexuel	Nom:Fem+PL
hétérosexuels	hétérosexuel	Adj:Mas+PL
hétérosexuels	hétérosexuel	Nom:Mas+PL
hétéroside	hétéroside	Nom:Mas+SG
hétérosides	hétéroside	Nom:Mas+PL
hétérotrophe	hétérotrophe	Adj:InvGen+SG
hétérotrophe	hétérotrophe	Nom:Mas+SG
hétérotrophes	hétérotrophe	Adj:InvGen+PL
hétérotrophes	hétérotrophe	Nom:Mas+PL
hétérozygote	hétérozygote	Adj:InvGen+SG
hétérozygote	hétérozygote	Nom:InvGen+SG
hetman	hetman	Nom:Mas+SG
hetmans	hetman	Nom:Mas+PL
hêtraie	hêtraie	Nom:Fem+SG
hêtre	hêtre	Nom:Mas+SG
hêtres	hêtre	Nom:Mas+PL
heu	heu	Int
heu	heu	Nom:Mas+SG
heure	heure	Nom:Fem+SG
heures	heure	Nom:Fem+PL
heures	heures	Nom:Fem+PL
heureuse	heureux	Adj:Fem+SG
heureuse	heureux	Nom:Fem+SG
heureusement	heureusement	Adv
heureuses	heureux	Adj:Fem+PL
heureuses	heureux	Nom:Fem+PL
heureux	heureux	Adj:Mas+InvPL
heureux	heureux	Nom:Mas+InvPL
heur	heur	Nom:Mas+SG
heuristique	heuristique	Adj:InvGen+SG
heuristique	heuristique	Nom:Fem+SG
heuristiques	heuristique	Adj:InvGen+PL
heuristiques	heuristique	Nom:Fem+PL
heurta	heurter	Ver:IPSim+SG+P3
heurtaient	heurter	Ver:IImp+PL+P3
heurtai	heurter	Ver:IPSim+SG+P1
heurtais	heurter	Ver:IImp+SG+P1:IImp+SG+P2
heurtait	heurter	Ver:IImp+SG+P3
heurtâmes	heurter	Ver:IPSim+PL+P1
heurtant	heurter	Ver:PPre
heurtas	heurter	Ver:IPSim+SG+P2
heurtasse	heurter	Ver:SImp+SG+P1
heurtassent	heurter	Ver:SImp+PL+P3
heurtasses	heurter	Ver:SImp+SG+P2
heurtassiez	heurter	Ver:SImp+PL+P2
heurtassions	heurter	Ver:SImp+PL+P1
heurtâtes	heurter	Ver:IPSim+PL+P2
heurtât	heurter	Ver:SImp+SG+P3
heurtée	heurté	Adj:Fem+SG
heurtée	heurter	Ver:PPas+Fem+SG
heurtées	heurté	Adj:Fem+PL
heurtées	heurter	Ver:PPas+Fem+PL
heurté	heurté	Adj:Mas+SG
heurte	heurter	Ver:IPre+SG+P1:IPre+SG+P3:SPre+SG+P1:SPre+SG+P3:ImPre+SG+P2
heurté	heurter	Ver:PPas+Mas+SG
heurtent	heurter	Ver:IPre+PL+P3:SPre+PL+P3
heurtera	heurter	Ver:IFut+SG+P3
heurteraient	heurter	Ver:CPre+PL+P3
heurterai	heurter	Ver:IFut+SG+P1
heurterais	heurter	Ver:CPre+SG+P1:CPre+SG+P2
heurterait	heurter	Ver:CPre+SG+P3
heurteras	heurter	Ver:IFut+SG+P2
heurtèrent	heurter	Ver:IPSim+PL+P3
heurterez	heurter	Ver:IFut+PL+P2
heurter	heurter	Ver:Inf
heurteriez	heurter	Ver:CPre+PL+P2
heurterions	heurter	Ver:CPre+PL+P1
heurterons	heurter	Ver:IFut+PL+P1
heurteront	heurter	Ver:IFut+PL+P3
heurtés	heurté	Adj:Mas+PL
heurtes	heurter	Ver:IPre+SG+P2:SPre+SG+P2
heurtés	heurter	Ver:PPas+Mas+PL
heurtez	heurter	Ver:IPre+PL+P2:ImPre+PL+P2
heurt	heurt	Nom:Mas+SG
heurtiez	heurter	Ver:IImp+PL+P2:SPre+PL+P2
heurtions	heurter	Ver:IImp+PL+P1:SPre+PL+P1
heurtoir	heurtoir	Nom:Mas+SG
heurtoirs	heurtoir	Nom:Mas+PL
heurtons	heurter	Ver:IPre+PL+P1:ImPre+PL+P1
heurts	heurt	Nom:Mas+PL
hévéa	hévéa	Nom:Mas+SG
hévéas	hévéa	Nom:Mas+PL
hexacoralliaire	hexacoralliaire	Nom:Mas+SG
hexacoralliaires	hexacoralliaire	Nom:Mas+PL
hexacorde	hexacorde	Nom:Mas+SG
hexacordes	hexacorde	Nom:Mas+PL
hexadécimale	hexadécimal	Adj:Fem+SG
hexadécimales	hexadécimal	Adj:Fem+PL
hexadécimal	hexadécimal	Adj:Mas+SG
hexadécimaux	hexadécimal	Adj:Mas+PL
hexaèdre	hexaèdre	Nom:Mas+SG
hexafluorure	hexafluorure	Nom:Mas+SG
hexafluorures	hexafluorure	Nom:Mas+PL
hexagonale	hexagonal	Adj:Fem+SG
hexagonales	hexagonal	Adj:Fem+PL
hexagonal	hexagonal	Adj:Mas+SG
hexagonaux	hexagonal	Adj:Mas+PL
hexagone	hexagone	Nom:Mas+SG
hexagones	hexagone	Nom:Mas+PL
hexamètre	hexamètre	Adj:InvGen+SG
hexamètre	hexamètre	Nom:Mas+SG
hexamètres	hexamètre	Adj:InvGen+PL
hexamètres	hexamètre	Nom:Mas+PL
hexapode	hexapode	Adj:InvGen+SG
hexapodes	hexapode	Adj:InvGen+PL
hexose	hexose	Nom:Mas+SG
hexoses	hexose	Nom:Mas+PL
h	h	Nom:Mas+InvPL
hiatale	hiatal	Adj:Fem+SG
hiatales	hiatal	Adj:Fem+PL
hiatal	hiatal	Adj:Mas+SG
hiataux	hiatal	Adj:Mas+PL
hiatus	hiatus	Nom:Mas+InvPL
hiberna	hiberner	Ver:IPSim+SG+P3
hibernaient	hiberner	Ver:IImp+PL+P3
hibernai	hiberner	Ver:IPSim+SG+P1
hibernais	hiberner	Ver:IImp+SG+P1:IImp+SG+P2
hibernait	hiberner	Ver:IImp+SG+P3
hibernale	hibernal	Adj:Fem+SG
hibernales	hibernal	Adj:Fem+PL
hibernal	hibernal	Adj:Mas+SG
hibernâmes	hiberner	Ver:IPSim+PL+P1
hibernante	hibernant	Adj:Fem+SG
hibernantes	hibernant	Adj:Fem+PL
hibernant	hibernant	Adj:Mas+SG
hibernant	hiberner	Ver:PPre
hibernants	hibernant	Adj:Mas+PL
hibernas	hiberner	Ver:IPSim+SG+P2
hibernasse	hiberner	Ver:SImp+SG+P1
hibernassent	hiberner	Ver:SImp+PL+P3
hibernasses	hiberner	Ver:SImp+SG+P2
hibernassiez	hiberner	Ver:SImp+PL+P2
hibernassions	hiberner	Ver:SImp+PL+P1
hibernâtes	hiberner	Ver:IPSim+PL+P2
hibernât	hiberner	Ver:SImp+SG+P3
hibernation	hibernation	Nom:Fem+SG
hibernations	hibernation	Nom:Fem+PL
hibernaux	hibernal	Adj:Mas+PL
hiberne	hiberner	Ver:IPre+SG+P1:IPre+SG+P3:SPre+SG+P1:SPre+SG+P3:ImPre+SG+P2
hiberné	hiberner	Ver:PPas+Mas+SG
hibernent	hiberner	Ver:IPre+PL+P3:SPre+PL+P3
hibernera	hiberner	Ver:IFut+SG+P3
hiberneraient	hiberner	Ver:CPre+PL+P3
hibernerai	hiberner	Ver:IFut+SG+P1
hibernerais	hiberner	Ver:CPre+SG+P1:CPre+SG+P2
hibernerait	hiberner	Ver:CPre+SG+P3
hiberneras	hiberner	Ver:IFut+SG+P2
hibernèrent	hiberner	Ver:IPSim+PL+P3
hibernerez	hiberner	Ver:IFut+PL+P2
hiberner	hiberner	Ver:Inf
hiberneriez	hiberner	Ver:CPre+PL+P2
hibernerions	hiberner	Ver:CPre+PL+P1
hibernerons	hiberner	Ver:IFut+PL+P1
hiberneront	hiberner	Ver:IFut+PL+P3
hibernes	hiberner	Ver:IPre+SG+P2:SPre+SG+P2
hibernez	hiberner	Ver:IPre+PL+P2:ImPre+PL+P2
hiberniez	hiberner	Ver:IImp+PL+P2:SPre+PL+P2
hibernions	hiberner	Ver:IImp+PL+P1:SPre+PL+P1
hibernons	hiberner	Ver:IPre+PL+P1:ImPre+PL+P1
hibiscus	hibiscus	Nom:Mas+InvPL
hibou	hibou	Nom:Mas+SG
hiboux	hibou	Nom:Mas+PL
hic	hic	Nom:Mas+InvPL
hickory	hickory	Nom:Mas+SG
hidalgo	hidalgo	Nom:Mas+SG
hideur	hideur	Nom:Fem+SG
hideuse	hideux	Adj:Fem+SG
hideusement	hideusement	Adv
hideuses	hideux	Adj:Fem+PL
hideux	hideux	Adj:Mas+InvPL
hidrosadénite	hidrosadénite	Nom:Fem+SG
hidrosadénites	hidrosadénite	Nom:Fem+PL
hièble	hièble	Nom:Fem+SG
hièbles	hièble	Nom:Fem+PL
hie	hie	Nom:Fem+SG
hiémale	hiémal	Adj:Fem+SG
hiémales	hiémal	Adj:Fem+PL
hiémal	hiémal	Adj:Mas+SG
hiémaux	hiémal	Adj:Mas+PL
hiérarchie	hiérarchie	Nom:Fem+SG
hiérarchies	hiérarchie	Nom:Fem+PL
hiérarchique	hiérarchique	Adj:InvGen+SG
hiérarchiquement	hiérarchiquement	Adv
hiérarchiques	hiérarchique	Adj:InvGen+PL
hiérarchisa	hiérarchiser	Ver:IPSim+SG+P3
hiérarchisaient	hiérarchiser	Ver:IImp+PL+P3
hiérarchisai	hiérarchiser	Ver:IPSim+SG+P1
hiérarchisais	hiérarchiser	Ver:IImp+SG+P1:IImp+SG+P2
hiérarchisait	hiérarchiser	Ver:IImp+SG+P3
hiérarchisâmes	hiérarchiser	Ver:IPSim+PL+P1
hiérarchisant	hiérarchiser	Ver:PPre
hiérarchisas	hiérarchiser	Ver:IPSim+SG+P2
hiérarchisasse	hiérarchiser	Ver:SImp+SG+P1
hiérarchisassent	hiérarchiser	Ver:SImp+PL+P3
hiérarchisasses	hiérarchiser	Ver:SImp+SG+P2
hiérarchisassiez	hiérarchiser	Ver:SImp+PL+P2
hiérarchisassions	hiérarchiser	Ver:SImp+PL+P1
hiérarchisâtes	hiérarchiser	Ver:IPSim+PL+P2
hiérarchisât	hiérarchiser	Ver:SImp+SG+P3
hiérarchisation	hiérarchisation	Nom:Fem+SG
hiérarchisations	hiérarchisation	Nom:Fem+PL
hiérarchisée	hiérarchiser	Ver:PPas+Fem+SG
hiérarchisées	hiérarchiser	Ver:PPas+Fem+PL
hiérarchise	hiérarchiser	Ver:IPre+SG+P1:IPre+SG+P3:SPre+SG+P1:SPre+SG+P3:ImPre+SG+P2
hiérarchisé	hiérarchiser	Ver:PPas+Mas+SG
hiérarchisent	hiérarchiser	Ver:IPre+PL+P3:SPre+PL+P3
hiérarchisera	hiérarchiser	Ver:IFut+SG+P3
hiérarchiseraient	hiérarchiser	Ver:CPre+PL+P3
hiérarchiserai	hiérarchiser	Ver:IFut+SG+P1
hiérarchiserais	hiérarchiser	Ver:CPre+SG+P1:CPre+SG+P2
hiérarchiserait	hiérarchiser	Ver:CPre+SG+P3
hiérarchiseras	hiérarchiser	Ver:IFut+SG+P2
hiérarchisèrent	hiérarchiser	Ver:IPSim+PL+P3
hiérarchiserez	hiérarchiser	Ver:IFut+PL+P2
hiérarchiser	hiérarchiser	Ver:Inf
hiérarchiseriez	hiérarchiser	Ver:CPre+PL+P2
hiérarchiserions	hiérarchiser	Ver:CPre+PL+P1
hiérarchiserons	hiérarchiser	Ver:IFut+PL+P1
hiérarchiseront	hiérarchiser	Ver:IFut+PL+P3
hiérarchises	hiérarchiser	Ver:IPre+SG+P2:SPre+SG+P2
hiérarchisés	hiérarchiser	Ver:PPas+Mas+PL
hiérarchisez	hiérarchiser	Ver:IPre+PL+P2:ImPre+PL+P2
hiérarchisiez	hiérarchiser	Ver:IImp+PL+P2:SPre+PL+P2
hiérarchisions	hiérarchiser	Ver:IImp+PL+P1:SPre+PL+P1
hiérarchisons	hiérarchiser	Ver:IPre+PL+P1:ImPre+PL+P1
hiérarque	hiérarque	Nom:Mas+SG
hiérarques	hiérarque	Nom:Mas+PL
hiératique	hiératique	Adj:InvGen+SG
hiératique	hiératique	Nom:Mas+SG
hiératiquement	hiératiquement	Adv
hiératiques	hiératique	Adj:InvGen+PL
hiératiques	hiératique	Nom:Mas+PL
hiératisme	hiératisme	Nom:Mas+SG
hier	hier	Adv
hier	hier	Nom:Mas+SG
hiérogamie	hiérogamie	Nom:Fem+SG
hiérogamies	hiérogamie	Nom:Fem+PL
hiéroglyphe	hiéroglyphe	Nom:Mas+SG
hiéroglyphes	hiéroglyphe	Nom:Mas+PL
hiéroglyphique	hiéroglyphique	Adj:InvGen+SG
hiérogrammate	hiérogrammate	Nom:Mas+SG
hiérogrammatiste	hiérogrammatiste	Nom:Mas+SG
hiérosolymitain	hiérosolymitain	Adj:Mas+SG
hiérosolymite	hiérosolymite	Adj:InvGen+SG
hies	hie	Nom:Fem+PL
highlander	highlander	Nom:Mas+SG
highlanders	highlander	Nom:Mas+PL
hi	hi	Int
hilaire	hilaire	Adj:InvGen+SG
hilarante	hilarant	Adj:Fem+SG
hilarantes	hilarant	Adj:Fem+PL
hilarant	hilarant	Adj:Mas+SG
hilarants	hilarant	Adj:Mas+PL
hilare	hilare	Adj:InvGen+SG
hilares	hilare	Adj:InvGen+PL
hilarité	hilarité	Nom:Fem+SG
hile	hile	Nom:Mas+SG
hiles	hile	Nom:Mas+PL
hiloire	hiloire	Nom:Fem+SG
hiloires	hiloire	Nom:Fem+PL
himalayen	himalayen	Adj:Mas+SG
himalayenne	himalayen	Adj:Fem+SG
himalayennes	himalayen	Adj:Fem+PL
himalayens	himalayen	Adj:Mas+PL
himation	himation	Nom:Mas+SG
hindi	hindi	Adj:InvGen+SG:InvGen+PL
hindi	hindi	Nom:Mas+SG
hindoue	hindou	Adj:Fem+SG
hindoue	hindou	Nom:Fem+SG
hindoues	hindou	Adj:Fem+PL
hindoues	hindou	Nom:Fem+PL
hindou	hindou	Adj:Mas+SG
hindou	hindou	Nom:Mas+SG
hindouisme	hindouisme	Nom:Mas+SG
hindouiste	hindouiste	Adj:InvGen+SG
hindouiste	hindouiste	Nom:InvGen+SG
hindous	hindou	Adj:Mas+PL
hindous	hindou	Nom:Mas+PL
hindoustani	hindoustani	Adj:InvGen+SG:InvGen+PL
hinterland	hinterland	Nom:Mas+SG
hipparchie	hipparchie	Nom:Fem+SG
hipparchies	hipparchie	Nom:Fem+PL
hipparion	hipparion	Nom:Mas+SG
hipparions	hipparion	Nom:Mas+PL
hipparque	hipparque	Nom:Mas+SG
hippiatre	hippiatre	Nom:InvGen+SG
hippiatres	hippiatre	Nom:InvGen+PL
hippiatrie	hippiatrie	Nom:Fem+SG
hippiatries	hippiatrie	Nom:Fem+PL
hippiatrique	hippiatrique	Adj:InvGen+SG
hippiatrique	hippiatrique	Nom:Fem+SG
hippiatriques	hippiatrique	Adj:InvGen+PL
hippiatriques	hippiatrique	Nom:Fem+PL
hippie	hippie	Adj:InvGen+SG
hippies	hippie	Adj:InvGen+PL
hippies	hippie	Nom:InvGen+PL
hippique	hippique	Adj:InvGen+SG
hippiques	hippique	Adj:InvGen+PL
hippisme	hippisme	Nom:Mas+SG
hippocampe	hippocampe	Nom:Mas+SG
hippocampes	hippocampe	Nom:Mas+PL
hippocastanacées	hippocastanacée	Nom:Fem+PL
hippocratique	hippocratique	Adj:InvGen+SG
hippocratisme	hippocratisme	Nom:Mas+SG
hippodrome	hippodrome	Nom:Mas+SG
hippodromes	hippodrome	Nom:Mas+PL
hippogriffe	hippogriffe	Nom:Mas+SG
hippologie	hippologie	Nom:Fem+SG
hippologique	hippologique	Adj:InvGen+SG
hippomobile	hippomobile	Adj:InvGen+SG
hippophagique	hippophagique	Adj:InvGen+SG
hippophagiques	hippophagique	Adj:InvGen+PL
hippopotame	hippopotame	Nom:Mas+SG
hippopotames	hippopotame	Nom:Mas+PL
hippopotamesque	hippopotamesque	Adj:InvGen+SG
hippurique	hippurique	Adj:InvGen+SG
hippuriques	hippurique	Adj:InvGen+PL
hippy	hippy	Adj:InvGen+SG:InvGen+PL
hippy	hippy	Nom:InvGen+SG
hircine	hircin	Adj:Fem+SG
hircines	hircin	Adj:Fem+PL
hircin	hircin	Adj:Mas+SG
hircins	hircin	Adj:Mas+PL
hirondeau	hirondeau	Nom:Mas+SG
hirondeaux	hirondeau	Nom:Mas+PL
hirondelle	hirondelle	Nom:Fem+SG
hirondelles	hirondelle	Nom:Fem+PL
hirsute	hirsute	Adj:InvGen+SG
hirsute	hirsute	Nom:Mas+SG
hirsutes	hirsute	Adj:InvGen+PL
hirsutes	hirsute	Nom:Mas+PL
hirsutisme	hirsutisme	Nom:Mas+SG
hirsutismes	hirsutisme	Nom:Mas+PL
hirudinées	hirudinée	Nom:Fem+PL
hispanique	hispanique	Adj:InvGen+SG
hispaniques	hispanique	Adj:InvGen+PL
hispanisante	hispanisant	Adj:Fem+SG
hispanisantes	hispanisant	Adj:Fem+PL
hispanisant	hispanisant	Adj:Mas+SG
hispanisants	hispanisant	Adj:Mas+PL
hispanisme	hispanisme	Nom:Mas+SG
hispanismes	hispanisme	Nom:Mas+PL
hispano-américaine	hispano-américain	Adj:Fem+SG
hispano-américaines	hispano-américain	Adj:Fem+PL
hispano-américain	hispano-américain	Adj:Mas+SG
hispano-américains	hispano-américain	Adj:Mas+PL
hispano-arabe	hispano-arabe	Adj:InvGen+SG
hispide	hispide	Adj:InvGen+SG
hispides	hispide	Adj:InvGen+PL
hissa	hisser	Ver:IPSim+SG+P3
hissaient	hisser	Ver:IImp+PL+P3
hissai	hisser	Ver:IPSim+SG+P1
hissais	hisser	Ver:IImp+SG+P1:IImp+SG+P2
hissait	hisser	Ver:IImp+SG+P3
hissâmes	hisser	Ver:IPSim+PL+P1
hissant	hisser	Ver:PPre
hissas	hisser	Ver:IPSim+SG+P2
hissasse	hisser	Ver:SImp+SG+P1
hissassent	hisser	Ver:SImp+PL+P3
hissasses	hisser	Ver:SImp+SG+P2
hissassiez	hisser	Ver:SImp+PL+P2
hissassions	hisser	Ver:SImp+PL+P1
hissâtes	hisser	Ver:IPSim+PL+P2
hissât	hisser	Ver:SImp+SG+P3
hissée	hisser	Ver:PPas+Fem+SG
hissées	hisser	Ver:PPas+Fem+PL
hisse	hisser	Ver:IPre+SG+P1:IPre+SG+P3:SPre+SG+P1:SPre+SG+P3:ImPre+SG+P2
hissé	hisser	Ver:PPas+Mas+SG
hissent	hisser	Ver:IPre+PL+P3:SPre+PL+P3
hissera	hisser	Ver:IFut+SG+P3
hisseraient	hisser	Ver:CPre+PL+P3
hisserai	hisser	Ver:IFut+SG+P1
hisserais	hisser	Ver:CPre+SG+P1:CPre+SG+P2
hisserait	hisser	Ver:CPre+SG+P3
hisseras	hisser	Ver:IFut+SG+P2
hissèrent	hisser	Ver:IPSim+PL+P3
hisserez	hisser	Ver:IFut+PL+P2
hisser	hisser	Ver:Inf
hisseriez	hisser	Ver:CPre+PL+P2
hisserions	hisser	Ver:CPre+PL+P1
hisserons	hisser	Ver:IFut+PL+P1
hisseront	hisser	Ver:IFut+PL+P3
hisses	hisser	Ver:IPre+SG+P2:SPre+SG+P2
hissés	hisser	Ver:PPas+Mas+PL
hissez	hisser	Ver:IPre+PL+P2:ImPre+PL+P2
hissiez	hisser	Ver:IImp+PL+P2:SPre+PL+P2
hissions	hisser	Ver:IImp+PL+P1:SPre+PL+P1
hissons	hisser	Ver:IPre+PL+P1:ImPre+PL+P1
histamine	histamine	Nom:Fem+SG
histamines	histamine	Nom:Fem+PL
histaminique	histaminique	Adj:InvGen+SG
histaminiques	histaminique	Adj:InvGen+PL
histidine	histidine	Nom:Fem+SG
histidines	histidine	Nom:Fem+PL
histocompatibilité	histocompatibilité	Nom:Fem+SG
histocompatibilités	histocompatibilité	Nom:Fem+PL
histogenèse	histogenèse	Nom:Fem+SG
histogenèses	histogenèse	Nom:Fem+PL
histogramme	histogramme	Nom:Mas+SG
histogrammes	histogramme	Nom:Mas+PL
histoire	histoire	Nom:Fem+SG
histoires	histoire	Nom:Fem+PL
histoires	histoires	Nom:Fem+PL
histologie	histologie	Nom:Fem+SG
histologique	histologique	Adj:InvGen+SG
histologiquement	histologiquement	Adv
histologiste	histologiste	Nom:InvGen+SG
histolyse	histolyse	Nom:Fem+SG
histone	histone	Nom:Fem+SG
histoplasmose	histoplasmose	Nom:Fem+SG
historadiographie	historadiographie	Nom:Fem+SG
historiant	historier	Ver:PPre
historicisme	historicisme	Nom:Mas+SG
historiciste	historiciste	Adj:InvGen+SG
historiciste	historiciste	Nom:InvGen+SG
historicité	historicité	Nom:Fem+SG
historiée	historié	Adj:Fem+SG
historiée	historier	Ver:PPas+Fem+SG
historiées	historié	Adj:Fem+PL
historiées	historier	Ver:PPas+Fem+PL
historié	historié	Adj:Mas+SG
historié	historier	Ver:PPas+Mas+SG
historien	historien	Nom:Mas+SG
historienne	historien	Nom:Fem+SG
historiennes	historien	Nom:Fem+PL
historiens	historien	Nom:Mas+PL
historier	historier	Ver:Inf
historiette	historiette	Nom:Fem+SG
historiettes	historiette	Nom:Fem+PL
historiographe	historiographe	Nom:InvGen+SG
historiographes	historiographe	Nom:InvGen+PL
historiographie	historiographie	Nom:Fem+SG
historiographique	historiographique	Adj:InvGen+SG
historique	historique	Adj:InvGen+SG
historique	historique	Nom:Mas+SG
historiquement	historiquement	Adv
historiques	historique	Adj:InvGen+PL
historiques	historique	Nom:Mas+PL
historisante	historisant	Adj:Fem+SG
historisantes	historisant	Adj:Fem+PL
historisant	historisant	Adj:Mas+SG
historisant	historiser	Ver:PPre
historisme	historisme	Nom:Mas+SG
histotoxique	histotoxique	Adj:InvGen+SG
histrion	histrion	Nom:Mas+SG
histrionique	histrionique	Adj:InvGen+SG
histrionisme	histrionisme	Nom:Mas+SG
histrions	histrion	Nom:Mas+PL
hit	hit	Nom:Mas+SG
hitlérien	hitlérien	Adj:Mas+SG
hitlérien	hitlérien	Nom:Mas+SG
hitlérienne	hitlérien	Adj:Fem+SG
hitlérienne	hitlérien	Nom:Fem+SG
hitlériennes	hitlérien	Adj:Fem+PL
hitlériennes	hitlérien	Nom:Fem+PL
hitlérisme	hitlérisme	Nom:Mas+SG
hittite	hittite	Adj:InvGen+SG
hittite	hittite	Nom:InvGen+SG
hittite	hittite	Nom:Mas+SG
hittites	hittite	Adj:InvGen+PL
hittites	hittite	Nom:InvGen+PL
hit-parade	hit-parade	Nom:Mas+SG
hiver	hiver	Nom:Mas+SG
hivernage	hivernage	Nom:Mas+SG
hivernages	hivernage	Nom:Mas+PL
hiverna	hiverner	Ver:IPSim+SG+P3
hivernaient	hiverner	Ver:IImp+PL+P3
hivernai	hiverner	Ver:IPSim+SG+P1
hivernais	hiverner	Ver:IImp+SG+P1:IImp+SG+P2
hivernait	hiverner	Ver:IImp+SG+P3
hivernale	hivernal	Adj:Fem+SG
hivernale	hivernale	Nom:Fem+SG
hivernales	hivernal	Adj:Fem+PL
hivernales	hivernale	Nom:Fem+PL
hivernal	hivernal	Adj:Mas+SG
hivernâmes	hiverner	Ver:IPSim+PL+P1
hivernante	hivernant	Adj:Fem+SG
hivernante	hivernant	Nom:Fem+SG
hivernantes	hivernant	Adj:Fem+PL
hivernantes	hivernant	Nom:Fem+PL
hivernant	hivernant	Adj:Mas+SG
hivernant	hivernant	Nom:Mas+SG
hivernant	hiverner	Ver:PPre
hivernants	hivernant	Adj:Mas+PL
hivernants	hivernant	Nom:Mas+PL
hivernas	hiverner	Ver:IPSim+SG+P2
hivernasse	hiverner	Ver:SImp+SG+P1
hivernassent	hiverner	Ver:SImp+PL+P3
hivernasses	hiverner	Ver:SImp+SG+P2
hivernassiez	hiverner	Ver:SImp+PL+P2
hivernassions	hiverner	Ver:SImp+PL+P1
hivernâtes	hiverner	Ver:IPSim+PL+P2
hivernât	hiverner	Ver:SImp+SG+P3
hivernaux	hivernal	Adj:Mas+PL
hiverne	hiverner	Ver:IPre+SG+P1:IPre+SG+P3:SPre+SG+P1:SPre+SG+P3:ImPre+SG+P2
hiverné	hiverner	Ver:PPas+Mas+SG
hivernent	hiverner	Ver:IPre+PL+P3:SPre+PL+P3
hivernèrent	hiverner	Ver:IPSim+PL+P3
hiverner	hiverner	Ver:Inf
hivernes	hiverner	Ver:IPre+SG+P2:SPre+SG+P2
hivernez	hiverner	Ver:Imp+PL+P2
hivernez	hiverner	Ver:IPre+PL+P2
hiverniez	hiverner	Ver:IImp+PL+P2:SPre+PL+P2
hivernions	hiverner	Ver:IImp+PL+P1:SPre+PL+P1
hivernons	hiverner	Ver:Imp+PL+P1
hivernons	hiverner	Ver:IPre+PL+P1
hivers	hiver	Nom:Mas+PL
hi-fi	hi-fi	Adj:InvGen+InvPL
hi-fi	hi-fi	Nom:Fem+InvPL
hi-han	hi-han	Nom:Mas+SG
hobbies	hobby	Nom:Mas+PL
hobby	hobby	Nom:Mas+SG
hobereau	hobereau	Nom:Mas+SG
hobereaux	hobereau	Nom:Mas+PL
hocco	hocco	Nom:Mas+SG
hocha	hocher	Ver:IPSim+SG+P3
hochaient	hocher	Ver:IImp+PL+P3
hochai	hocher	Ver:IPSim+SG+P1
hochais	hocher	Ver:IImp+SG+P1:IImp+SG+P2
hochait	hocher	Ver:IImp+SG+P3
hochâmes	hocher	Ver:IPSim+PL+P1
hochant	hocher	Ver:PPre
hochas	hocher	Ver:IPSim+SG+P2
hochasse	hocher	Ver:SImp+SG+P1
hochassent	hocher	Ver:SImp+PL+P3
hochasses	hocher	Ver:SImp+SG+P2
hochassiez	hocher	Ver:SImp+PL+P2
hochassions	hocher	Ver:SImp+PL+P1
hochâtes	hocher	Ver:IPSim+PL+P2
hochât	hocher	Ver:SImp+SG+P3
hochée	hochée	Nom:Fem+SG
hochée	hocher	Ver:PPas+Fem+SG
hochées	hochée	Nom:Fem+PL
hochées	hocher	Ver:PPas+Fem+PL
hoche	hoche	Nom:Fem+SG
hoche	hocher	Ver:IPre+SG+P1:IPre+SG+P3:SPre+SG+P1:SPre+SG+P3:ImPre+SG+P2
hoché	hocher	Ver:PPas+Mas+SG
hochement	hochement	Nom:Mas+SG
hochements	hochement	Nom:Mas+PL
hochent	hocher	Ver:IPre+PL+P3:SPre+PL+P3
hochepot	hochepot	Nom:Mas+SG
hochequeue	hochequeue	Nom:Mas+SG
hochequeues	hochequeue	Nom:Mas+PL
hochera	hocher	Ver:IFut+SG+P3
hocheraient	hocher	Ver:CPre+PL+P3
hocherai	hocher	Ver:IFut+SG+P1
hocherais	hocher	Ver:CPre+SG+P1:CPre+SG+P2
hocherait	hocher	Ver:CPre+SG+P3
hocheras	hocher	Ver:IFut+SG+P2
hochèrent	hocher	Ver:IPSim+PL+P3
hocherez	hocher	Ver:IFut+PL+P2
hocher	hocher	Ver:Inf
hocheriez	hocher	Ver:CPre+PL+P2
hocherions	hocher	Ver:CPre+PL+P1
hocherons	hocher	Ver:IFut+PL+P1
hocheront	hocher	Ver:IFut+PL+P3
hoches	hoche	Nom:Fem+PL
hoches	hocher	Ver:IPre+SG+P2:SPre+SG+P2
hochés	hocher	Ver:PPas+Mas+PL
hochet	hochet	Nom:Mas+SG
hochets	hochet	Nom:Mas+PL
hochez	hocher	Ver:IPre+PL+P2:ImPre+PL+P2
hochiez	hocher	Ver:IImp+PL+P2:SPre+PL+P2
hochions	hocher	Ver:IImp+PL+P1:SPre+PL+P1
hochons	hocher	Ver:IPre+PL+P1:ImPre+PL+P1
hockeyeur	hockeyeur	Nom:Mas+SG
hockeyeurs	hockeyeur	Nom:Mas+PL
hockey	hockey	Nom:Mas+SG
hodjatoleslam	hodjatoleslam	Nom:Mas+SG
hodographe	hodographe	Nom:Mas+SG
ho	ho	Int
hoir	hoir	Nom:Mas+SG
hoirie	hoirie	Nom:Fem+SG
holà	holà	Int
holà	holà	Nom:Mas+InvPL
holarctique	holarctique	Adj:InvGen+SG
holding	holding	Nom:InvGen+SG
holding	holding	Nom:Mas+SG
holdings	holding	Nom:InvGen+PL
hold-up	hold-up	Nom:Mas+InvPL
hollandaise	hollandais	Adj:Fem+SG
hollandaise	hollandaise	Nom:Fem+SG
hollandaise	hollandais	Nom:Fem+SG
hollandaises	hollandais	Adj:Fem+PL
hollandaises	hollandaise	Nom:Fem+PL
hollandaises	hollandais	Nom:Fem+PL
hollandais	hollandais	Adj:Mas+InvPL
hollandais	hollandais	Nom:Mas+InvPL
hollandais	hollandais	Nom:Mas+SG
hollande	hollande	Nom:Fem+SG
hollande	hollande	Nom:Mas+SG
hollywoodien	hollywoodien	Adj:Mas+SG
holmium	holmium	Nom:Mas+SG
holocauste	holocauste	Nom:Mas+SG
holocaustes	holocauste	Nom:Mas+PL
holocène	holocène	Adj:InvGen+SG
holocène	holocène	Nom:Mas+SG
holocristallin	holocristallin	Adj:Mas+SG
hologramme	hologramme	Nom:Mas+SG
holographe	holographe	Adj:InvGen+SG
holographie	holographie	Nom:Fem+SG
holographique	holographique	Adj:InvGen+SG
holométrique	holométrique	Adj:InvGen+SG
holophrastique	holophrastique	Adj:InvGen+SG
holoprotéine	holoprotéine	Nom:Fem+SG
holoside	holoside	Nom:Mas+SG
holostéen	holostéen	Nom:Mas+SG
holothurie	holothurie	Nom:Fem+SG
homale	homal	Adj:Fem+SG
homal	homal	Adj:Mas+SG
homarderie	homarderie	Nom:Fem+SG
homard	homard	Nom:Mas+SG
homards	homard	Nom:Mas+PL
homaux	homal	Adj:Mas+PL
hombre	hombre	Nom:Mas+SG
home	home	Nom:Mas+SG
homélie	homélie	Nom:Fem+SG
homélies	homélie	Nom:Fem+PL
homéomorphe	homéomorphe	Adj:InvGen+SG
homéomorphisme	homéomorphisme	Nom:Mas+SG
homéopathe	homéopathe	Nom:InvGen+SG
homéopathes	homéopathe	Nom:InvGen+PL
homéopathie	homéopathie	Nom:Fem+SG
homéopathique	homéopathique	Adj:InvGen+SG
homéopathiques	homéopathique	Adj:InvGen+PL
homéostasie	homéostasie	Nom:Fem+SG
homéostat	homéostat	Nom:Mas+SG
homéostatique	homéostatique	Adj:InvGen+SG
homéotherme	homéotherme	Adj:InvGen+SG
homéotherme	homéotherme	Nom:Mas+SG
homéothermie	homéothermie	Nom:Fem+SG
homéride	homéride	Nom:Mas+SG
homérique	homérique	Adj:InvGen+SG
homériques	homérique	Adj:InvGen+PL
homespun	homespun	Nom:Mas+SG
home-trainer	home-trainer	Nom:Mas+SG
homicide	homicide	Adj:InvGen+SG
homicide	homicide	Nom:InvGen+SG
homicide	homicide	Nom:Mas+SG
homicides	homicide	Adj:InvGen+PL
homicides	homicide	Nom:InvGen+PL
homicides	homicide	Nom:Mas+PL
homie	homie	Nom:Fem+SG
homilétique	homilétique	Nom:Fem+SG
hominidé	hominidé	Nom:Mas+SG
hominien	hominien	Nom:Mas+SG
hominiens	hominien	Nom:Mas+PL
hominisation	hominisation	Nom:Fem+SG
hominisé	hominisé	Adj:Mas+SG
hominisé	hominiser	Ver:PPas+Mas+SG
hommage	hommage	Nom:Mas+SG
hommages	hommage	Nom:Mas+PL
hommages	hommages	Nom:Mas+PL
hommasse	hommasse	Adj:InvGen+SG
homme	homme	Nom:Mas+SG
hommes	homme	Nom:Mas+PL
hommes-grenouilles	homme-grenouille	Nom:Mas+PL
hommes-orchestres	homme-orchestre	Nom:Mas+PL
hommes-sandwichs	homme-sandwich	Nom:Mas+PL
homme-grenouille	homme-grenouille	Nom:Mas+SG
homme-orchestre	homme-orchestre	Nom:Mas+SG
homme-sandwich	homme-sandwich	Nom:Mas+SG
homocentrique	homocentrique	Adj:InvGen+SG
homocercie	homocercie	Nom:Fem+SG
homocerque	homocerque	Adj:InvGen+SG
homochromie	homochromie	Nom:Fem+SG
homocinétique	homocinétique	Adj:InvGen+SG
homocyclique	homocyclique	Adj:InvGen+SG
homodonte	homodonte	Adj:InvGen+SG
homofocale	homofocal	Adj:Fem+SG
homofocales	homofocal	Adj:Fem+PL
homofocal	homofocal	Adj:Mas+SG
homofocaux	homofocal	Adj:Mas+PL
homogame	homogame	Adj:InvGen+SG
homogamétie	homogamétie	Nom:Fem+SG
homogamétique	homogamétique	Adj:InvGen+SG
homogène	homogène	Adj:InvGen+SG
homogénéifier	homogénéifier	Ver:Inf
homogénéisa	homogénéiser	Ver:IPSim+SG+P3
homogénéisaient	homogénéiser	Ver:IImp+PL+P3
homogénéisai	homogénéiser	Ver:IPSim+SG+P1
homogénéisais	homogénéiser	Ver:IImp+SG+P1:IImp+SG+P2
homogénéisait	homogénéiser	Ver:IImp+SG+P3
homogénéisâmes	homogénéiser	Ver:IPSim+PL+P1
homogénéisant	homogénéiser	Ver:PPre
homogénéisas	homogénéiser	Ver:IPSim+SG+P2
homogénéisasse	homogénéiser	Ver:SImp+SG+P1
homogénéisassent	homogénéiser	Ver:SImp+PL+P3
homogénéisasses	homogénéiser	Ver:SImp+SG+P2
homogénéisassiez	homogénéiser	Ver:SImp+PL+P2
homogénéisassions	homogénéiser	Ver:SImp+PL+P1
homogénéisâtes	homogénéiser	Ver:IPSim+PL+P2
homogénéisateur	homogénéisateur	Adj:Mas+SG
homogénéisateur	homogénéisateur	Nom:Mas+SG
homogénéisât	homogénéiser	Ver:SImp+SG+P3
homogénéisation	homogénéisation	Nom:Fem+SG
homogénéisations	homogénéisation	Nom:Fem+PL
homogénéisatrice	homogénéisateur	Adj:Fem+SG
homogénéisée	homogénéisé	Adj:Fem+SG
homogénéisée	homogénéiser	Ver:PPas+Fem+SG
homogénéisées	homogénéisé	Adj:Fem+PL
homogénéisées	homogénéiser	Ver:PPas+Fem+PL
homogénéisé	homogénéisé	Adj:Mas+SG
homogénéise	homogénéiser	Ver:Imp+SG+P2
homogénéise	homogénéiser	Ver:IPre+SG+P1
homogénéise	homogénéiser	Ver:IPre+SG+P3
homogénéisé	homogénéiser	Ver:PPas+Mas+SG
homogénéise	homogénéiser	Ver:SPre+SG+P1
homogénéise	homogénéiser	Ver:SPre+SG+P3
homogénéisent	homogénéiser	Ver:IPre+PL+P3
homogénéisent	homogénéiser	Ver:SPre+PL+P3
homogénéisera	homogénéiser	Ver:IFut+SG+P3
homogénéiseraient	homogénéiser	Ver:CPre+PL+P3
homogénéiserai	homogénéiser	Ver:IFut+SG+P1
homogénéiserais	homogénéiser	Ver:CPre+SG+P1:CPre+SG+P2
homogénéiserait	homogénéiser	Ver:CPre+SG+P3
homogénéiseras	homogénéiser	Ver:IFut+SG+P2
homogénéisèrent	homogénéiser	Ver:IPSim+PL+P3
homogénéiserez	homogénéiser	Ver:IFut+PL+P2
homogénéiser	homogénéiser	Ver:Inf
homogénéiseriez	homogénéiser	Ver:CPre+PL+P2
homogénéiserions	homogénéiser	Ver:CPre+PL+P1
homogénéiserons	homogénéiser	Ver:IFut+PL+P1
homogénéiseront	homogénéiser	Ver:IFut+PL+P3
homogénéisés	homogénéisé	Adj:Mas+PL
homogénéises	homogénéiser	Ver:IPre+SG+P2
homogénéisés	homogénéiser	Ver:PPas+Mas+PL
homogénéises	homogénéiser	Ver:SPre+SG+P2
homogénéisez	homogénéiser	Ver:IPre+PL+P2:ImPre+PL+P2
homogénéisiez	homogénéiser	Ver:IImp+PL+P2:SPre+PL+P2
homogénéisions	homogénéiser	Ver:IImp+PL+P1:SPre+PL+P1
homogénéisons	homogénéiser	Ver:IPre+PL+P1:ImPre+PL+P1
homogénéité	homogénéité	Nom:Fem+SG
homogénéités	homogénéité	Nom:Fem+PL
homogènes	homogène	Adj:InvGen+PL
homographe	homographe	Adj:InvGen+SG
homographe	homographe	Nom:Mas+SG
homographes	homographe	Adj:InvGen+PL
homographes	homographe	Nom:Mas+PL
homographie	homographie	Nom:Fem+SG
homographies	homographie	Nom:Fem+PL
homographique	homographique	Adj:InvGen+SG
homographiques	homographique	Adj:InvGen+PL
homogreffe	homogreffe	Nom:Fem+SG
homogreffes	homogreffe	Nom:Fem+PL
homo	homo	Adj:InvGen+SG
homo	homo	Nom:InvGen+SG
homo	homo	Nom:Mas+SG
homologable	homologable	Adj:InvGen+SG
homologation	homologation	Nom:Fem+SG
homologations	homologation	Nom:Fem+PL
homologie	homologie	Nom:Fem+SG
homologique	homologique	Adj:InvGen+SG
homologua	homologuer	Ver:IPSim+SG+P3
homologuaient	homologuer	Ver:IImp+PL+P3
homologuai	homologuer	Ver:IPSim+SG+P1
homologuais	homologuer	Ver:IImp+SG+P1:IImp+SG+P2
homologuait	homologuer	Ver:IImp+SG+P3
homologuâmes	homologuer	Ver:IPSim+PL+P1
homologuant	homologuer	Ver:PPre
homologuas	homologuer	Ver:IPSim+SG+P2
homologuasse	homologuer	Ver:SImp+SG+P1
homologuassent	homologuer	Ver:SImp+PL+P3
homologuasses	homologuer	Ver:SImp+SG+P2
homologuassiez	homologuer	Ver:SImp+PL+P2
homologuassions	homologuer	Ver:SImp+PL+P1
homologuâtes	homologuer	Ver:IPSim+PL+P2
homologuât	homologuer	Ver:SImp+SG+P3
homologuée	homologué	Adj:Fem+SG
homologuée	homologuer	Ver:PPas+Fem+SG
homologuées	homologué	Adj:Fem+PL
homologuées	homologuer	Ver:PPas+Fem+PL
homologue	homologue	Adj:InvGen+SG
homologué	homologué	Adj:Mas+SG
homologue	homologue	Nom:InvGen+SG
homologue	homologue	Nom:Mas+SG
homologue	homologuer	Ver:IPre+SG+P1:IPre+SG+P3:SPre+SG+P1:SPre+SG+P3:ImPre+SG+P2
homologuent	homologuer	Ver:IPre+PL+P3:SPre+PL+P3
homologuera	homologuer	Ver:IFut+SG+P3
homologueraient	homologuer	Ver:CPre+PL+P3
homologuerai	homologuer	Ver:IFut+SG+P1
homologuerais	homologuer	Ver:CPre+SG+P1:CPre+SG+P2
homologuerait	homologuer	Ver:CPre+SG+P3
homologueras	homologuer	Ver:IFut+SG+P2
homologuèrent	homologuer	Ver:IPSim+PL+P3
homologuerez	homologuer	Ver:IFut+PL+P2
homologuer	homologuer	Ver:Inf
homologueriez	homologuer	Ver:CPre+PL+P2
homologuerions	homologuer	Ver:CPre+PL+P1
homologuerons	homologuer	Ver:IFut+PL+P1
homologueront	homologuer	Ver:IFut+PL+P3
homologues	homologue	Adj:InvGen+PL
homologués	homologué	Adj:Mas+PL
homologues	homologue	Nom:InvGen+PL
homologues	homologue	Nom:Mas+PL
homologues	homologuer	Ver:IPre+SG+P2:SPre+SG+P2
homologués	homologuer	Ver:PPas+Mas+PL
homologuez	homologuer	Ver:IPre+PL+P2:ImPre+PL+P2
homologuiez	homologuer	Ver:IImp+PL+P2:SPre+PL+P2
homologuions	homologuer	Ver:IImp+PL+P1:SPre+PL+P1
homologuons	homologuer	Ver:IPre+PL+P1:ImPre+PL+P1
homomorphisme	homomorphisme	Nom:Mas+SG
homomorphismes	homomorphisme	Nom:Mas+PL
homoncule	homoncule	Nom:Mas+SG
homonyme	homonyme	Adj:InvGen+SG
homonyme	homonyme	Nom:InvGen+SG
homonyme	homonyme	Nom:Mas+SG
homonymes	homonyme	Adj:InvGen+PL
homonymes	homonyme	Nom:InvGen+PL
homonymes	homonyme	Nom:Mas+PL
homonymie	homonymie	Nom:Fem+SG
homonymique	homonymique	Adj:InvGen+SG
homophone	homophone	Adj:InvGen+SG
homophones	homophone	Adj:InvGen+PL
homophonie	homophonie	Nom:Fem+SG
homoptère	homoptère	Nom:Mas+SG
homorganique	homorganique	Adj:InvGen+SG
homorythmique	homorythmique	Adj:InvGen+SG
homosexualité	homosexualité	Nom:Fem+SG
homosexuel	homosexuel	Adj:Mas+SG
homosexuel	homosexuel	Nom:Mas+SG
homosexuelle	homosexuel	Adj:Fem+SG
homosexuelle	homosexuel	Nom:Fem+SG
homosexuelles	homosexuel	Adj:Fem+PL
homosexuelles	homosexuel	Nom:Fem+PL
homosexuels	homosexuel	Adj:Mas+PL
homosexuels	homosexuel	Nom:Mas+PL
homuncule	homuncule	Nom:Mas+SG
honchet	honchet	Nom:Mas+SG
honchets	honchet	Nom:Mas+PL
hondurien	hondurien	Adj:Mas+SG
hongra	hongrer	Ver:IPSim+SG+P3
hongraient	hongrer	Ver:IImp+PL+P3
hongrai	hongrer	Ver:IPSim+SG+P1
hongrais	hongrer	Ver:IImp+SG+P1:IImp+SG+P2
hongrait	hongrer	Ver:IImp+SG+P3
hongrâmes	hongrer	Ver:IPSim+PL+P1
hongrant	hongrer	Ver:PPre
hongras	hongrer	Ver:IPSim+SG+P2
hongrasse	hongrer	Ver:SImp+SG+P1
hongrassent	hongrer	Ver:SImp+PL+P3
hongrasses	hongrer	Ver:SImp+SG+P2
hongrassiez	hongrer	Ver:SImp+PL+P2
hongrassions	hongrer	Ver:SImp+PL+P1
hongrâtes	hongrer	Ver:IPSim+PL+P2
hongrât	hongrer	Ver:SImp+SG+P3
hongre	hongre	Adj:Mas+SG
hongre	hongre	Nom:Mas+SG
hongre	hongrer	Ver:IPre+SG+P1:IPre+SG+P3:SPre+SG+P1:SPre+SG+P3:ImPre+SG+P2
hongré	hongrer	Ver:PPas+Mas+SG
hongrent	hongrer	Ver:IPre+PL+P3:SPre+PL+P3
hongrera	hongrer	Ver:IFut+SG+P3
hongreraient	hongrer	Ver:CPre+PL+P3
hongrerai	hongrer	Ver:IFut+SG+P1
hongrerais	hongrer	Ver:CPre+SG+P1:CPre+SG+P2
hongrerait	hongrer	Ver:CPre+SG+P3
hongreras	hongrer	Ver:IFut+SG+P2
hongrèrent	hongrer	Ver:IPSim+PL+P3
hongrerez	hongrer	Ver:IFut+PL+P2
hongrer	hongrer	Ver:Inf
hongreriez	hongrer	Ver:CPre+PL+P2
hongrerions	hongrer	Ver:CPre+PL+P1
hongrerons	hongrer	Ver:IFut+PL+P1
hongreront	hongrer	Ver:IFut+PL+P3
hongres	hongre	Adj:Mas+PL
hongres	hongre	Nom:Mas+PL
hongres	hongrer	Ver:IPre+SG+P2:SPre+SG+P2
hongreur	hongreur	Nom:Mas+SG
hongrez	hongrer	Ver:Imp+PL+P2
hongrez	hongrer	Ver:IPre+PL+P2
hongriez	hongrer	Ver:IImp+PL+P2:SPre+PL+P2
hongrions	hongrer	Ver:IImp+PL+P1:SPre+PL+P1
hongroient	hongroyer	Ver:IPre+PL+P3:SPre+PL+P3
hongroierie	hongroierie	Nom:Fem+SG
hongroies	hongroyer	Ver:IPre+SG+P2:SPre+SG+P2
hongroise	hongrois	Adj:Fem+SG
hongroise	hongrois	Nom:Fem+SG
hongroises	hongrois	Adj:Fem+PL
hongroises	hongrois	Nom:Fem+PL
hongrois	hongrois	Adj:Mas+InvPL
hongrois	hongrois	Nom:Mas+InvPL
hongrois	hongrois	Nom:Mas+SG
hongrons	hongrer	Ver:Imp+PL+P1
hongrons	hongrer	Ver:IPre+PL+P1
hongroyage	hongroyage	Nom:Mas+SG
hongroyages	hongroyage	Nom:Mas+PL
hongroyant	hongroyer	Ver:PPre
hongroyé	hongroyer	Ver:PPas+Mas+SG
hongroyer	hongroyer	Ver:Inf
hongroyeur	hongroyeur	Nom:Mas+SG
honing	honing	Nom:Mas+SG
honnête	honnête	Adj:InvGen+SG
honnêtement	honnêtement	Adv
honnêtes	honnête	Adj:InvGen+PL
honnêteté	honnêteté	Nom:Fem+SG
honnêtetés	honnêteté	Nom:Fem+PL
honneur	honneur	Nom:Mas+SG
honneurs	honneur	Nom:Mas+PL
honneurs	honneurs	Nom:Mas+PL
honnie	honnir	Ver:PPas+Fem+SG
honnies	honnir	Ver:PPas+Fem+PL
honni	honnir	Ver:PPas+Mas+SG
honnîmes	honnir	Ver:IPSim+PL+P1
honnira	honnir	Ver:IFut+SG+P3
honniraient	honnir	Ver:CPre+PL+P3
honnirai	honnir	Ver:IFut+SG+P1
honnirais	honnir	Ver:CPre+SG+P1:CPre+SG+P2
honnirait	honnir	Ver:CPre+SG+P3
honniras	honnir	Ver:IFut+SG+P2
honnirent	honnir	Ver:IPSim+PL+P3
honnirez	honnir	Ver:IFut+PL+P2
honnir	honnir	Ver:Inf
honniriez	honnir	Ver:CPre+PL+P2
honnirions	honnir	Ver:CPre+PL+P1
honnirons	honnir	Ver:IFut+PL+P1
honniront	honnir	Ver:IFut+PL+P3
honnis	honnir	Ver:PPas+Mas+PL:IPre+SG+P1:IPre+SG+P2:IPSim+SG+P1:IPSim+SG+P2:ImPre+SG+P2
honnissaient	honnir	Ver:IImp+PL+P3
honnissais	honnir	Ver:IImp+SG+P1:IImp+SG+P2
honnissait	honnir	Ver:IImp+SG+P3
honnissant	honnir	Ver:PPre
honnisse	honnir	Ver:SPre+SG+P1:SPre+SG+P3:SImp+SG+P1
honnissent	honnir	Ver:IPre+PL+P3:SPre+PL+P3:SImp+PL+P3
honnisses	honnir	Ver:SPre+SG+P2:SImp+SG+P2
honnissez	honnir	Ver:IPre+PL+P2:ImPre+PL+P2
honnissiez	honnir	Ver:IImp+PL+P2:SPre+PL+P2:SImp+PL+P2
honnissions	honnir	Ver:IImp+PL+P1:SPre+PL+P1:SImp+PL+P1
honnissons	honnir	Ver:IPre+PL+P1:ImPre+PL+P1
honnîtes	honnir	Ver:IPSim+PL+P2
honnit	honnir	Ver:IPre+SG+P3:IPSim+SG+P3
honnît	honnir	Ver:SImp+SG+P3
honorabilité	honorabilité	Nom:Fem+SG
honorable	honorable	Adj:InvGen+SG
honorablement	honorablement	Adv
honorables	honorable	Adj:InvGen+PL
honora	honorer	Ver:IPSim+SG+P3
honoraient	honorer	Ver:IImp+PL+P3
honorai	honorer	Ver:IPSim+SG+P1
honoraire	honoraire	Adj:InvGen+SG
honoraires	honoraire	Adj:InvGen+PL
honoraires	honoraires	Nom:Mas+PL
honorais	honorer	Ver:IImp+SG+P1:IImp+SG+P2
honorait	honorer	Ver:IImp+SG+P3
honorâmes	honorer	Ver:IPSim+PL+P1
honorant	honorer	Ver:PPre
honorariat	honorariat	Nom:Mas+SG
honoras	honorer	Ver:IPSim+SG+P2
honorasse	honorer	Ver:SImp+SG+P1
honorassent	honorer	Ver:SImp+PL+P3
honorasses	honorer	Ver:SImp+SG+P2
honorassiez	honorer	Ver:SImp+PL+P2
honorassions	honorer	Ver:SImp+PL+P1
honorâtes	honorer	Ver:IPSim+PL+P2
honorât	honorer	Ver:SImp+SG+P3
honorée	honoré	Adj:Fem+SG
honorée	honorée	Nom:Fem+SG
honorée	honorer	Ver:PPas+Fem+SG
honorées	honoré	Adj:Fem+PL
honorées	honorée	Nom:Fem+PL
honorées	honorer	Ver:PPas+Fem+PL
honoré	honoré	Adj:Mas+SG
honoré	honoré	Nom:Mas+InvPL
honore	honorer	Ver:IPre+SG+P1:IPre+SG+P3:SPre+SG+P1:SPre+SG+P3:ImPre+SG+P2
honoré	honorer	Ver:PPas+Mas+SG
honorent	honorer	Ver:IPre+PL+P3:SPre+PL+P3
honorera	honorer	Ver:IFut+SG+P3
honoreraient	honorer	Ver:CPre+PL+P3
honorerai	honorer	Ver:IFut+SG+P1
honorerais	honorer	Ver:CPre+SG+P1:CPre+SG+P2
honorerait	honorer	Ver:CPre+SG+P3
honoreras	honorer	Ver:IFut+SG+P2
honorèrent	honorer	Ver:IPSim+PL+P3
honorerez	honorer	Ver:IFut+PL+P2
honorer	honorer	Ver:Inf
honoreriez	honorer	Ver:CPre+PL+P2
honorerions	honorer	Ver:CPre+PL+P1
honorerons	honorer	Ver:IFut+PL+P1
honoreront	honorer	Ver:IFut+PL+P3
honorés	honoré	Adj:Mas+PL
honores	honorer	Ver:IPre+SG+P2:SPre+SG+P2
honorés	honorer	Ver:PPas+Mas+PL
honorez	honorer	Ver:IPre+PL+P2:ImPre+PL+P2
honoriez	honorer	Ver:IImp+PL+P2:SPre+PL+P2
honorifique	honorifique	Adj:InvGen+SG
honorifiques	honorifique	Adj:InvGen+PL
honorions	honorer	Ver:IImp+PL+P1:SPre+PL+P1
honorons	honorer	Ver:IPre+PL+P1:ImPre+PL+P1
honte	honte	Nom:Fem+SG
hontes	honte	Nom:Fem+PL
honteuse	honteux	Adj:Fem+SG
honteusement	honteusement	Adv
honteuses	honteux	Adj:Fem+PL
honteux	honteux	Adj:Mas+InvPL
hooligan	hooligan	Nom:Mas+SG
hopak	hopak	Nom:Mas+SG
hop	hop	Int
hôpital	hôpital	Nom:Mas+SG
hôpitaux	hôpital	Nom:Mas+PL
hoplite	hoplite	Nom:Mas+SG
hoplites	hoplite	Nom:Mas+PL
hoplites	hoplites	Nom:Mas+InvPL
hoqueta	hoqueter	Ver:IPSim+SG+P3
hoquetaient	hoqueter	Ver:IImp+PL+P3
hoquetai	hoqueter	Ver:IPSim+SG+P1
hoquetais	hoqueter	Ver:IImp+SG+P1:IImp+SG+P2
hoquetait	hoqueter	Ver:IImp+SG+P3
hoquetâmes	hoqueter	Ver:IPSim+PL+P1
hoquetant	hoqueter	Ver:PPre
hoquetas	hoqueter	Ver:IPSim+SG+P2
hoquetasse	hoqueter	Ver:SImp+SG+P1
hoquetassent	hoqueter	Ver:SImp+PL+P3
hoquetasses	hoqueter	Ver:SImp+SG+P2
hoquetassiez	hoqueter	Ver:SImp+PL+P2
hoquetassions	hoqueter	Ver:SImp+PL+P1
hoquetâtes	hoqueter	Ver:IPSim+PL+P2
hoquetât	hoqueter	Ver:SImp+SG+P3
hoqueté	hoqueter	Ver:PPas+Mas+SG
hoquetèrent	hoqueter	Ver:IPSim+PL+P3
hoqueter	hoqueter	Ver:Inf
hoquetez	hoqueter	Ver:IPre+PL+P2:ImPre+PL+P2
hoquet	hoquet	Nom:Mas+SG
hoquetiez	hoqueter	Ver:IImp+PL+P2:SPre+PL+P2
hoquetions	hoqueter	Ver:IImp+PL+P1:SPre+PL+P1
hoqueton	hoqueton	Nom:Mas+SG
hoquetons	hoqueter	Ver:IPre+PL+P1:ImPre+PL+P1
hoquetons	hoqueton	Nom:Mas+PL
hoquets	hoquet	Nom:Mas+PL
hoquette	hoqueter	Ver:IPre+SG+P1:IPre+SG+P3:SPre+SG+P1:SPre+SG+P3:ImPre+SG+P2
hoquettent	hoqueter	Ver:IPre+PL+P3:SPre+PL+P3
hoquettera	hoqueter	Ver:IFut+SG+P3
hoquetteraient	hoqueter	Ver:CPre+PL+P3
hoquetterai	hoqueter	Ver:IFut+SG+P1
hoquetterais	hoqueter	Ver:CPre+SG+P1:CPre+SG+P2
hoquetterait	hoqueter	Ver:CPre+SG+P3
hoquetteras	hoqueter	Ver:IFut+SG+P2
hoquetterez	hoqueter	Ver:IFut+PL+P2
hoquetteriez	hoqueter	Ver:CPre+PL+P2
hoquetterions	hoqueter	Ver:CPre+PL+P1
hoquetterons	hoqueter	Ver:IFut+PL+P1
hoquetteront	hoqueter	Ver:IFut+PL+P3
hoquettes	hoqueter	Ver:IPre+SG+P2:SPre+SG+P2
horaire	horaire	Adj:InvGen+SG
horaire	horaire	Nom:Mas+SG
horaires	horaire	Adj:InvGen+PL
horaires	horaire	Nom:Mas+PL
horde	horde	Nom:Fem+SG
hordéine	hordéine	Nom:Fem+SG
hordes	horde	Nom:Fem+PL
horion	horion	Nom:Mas+SG
horions	horion	Nom:Mas+PL
horizon	horizon	Nom:Mas+SG
horizons	horizon	Nom:Mas+PL
horizontale	horizontal	Adj:Fem+SG
horizontale	horizontale	Nom:Fem+SG
horizontalement	horizontalement	Adv
horizontales	horizontal	Adj:Fem+PL
horizontales	horizontale	Nom:Fem+PL
horizontal	horizontal	Adj:Mas+SG
horizontalité	horizontalité	Nom:Fem+SG
horizontaux	horizontal	Adj:Mas+PL
horloge	horloge	Nom:Fem+SG
horlogère	horloger	Adj:Fem+SG
horlogère	horloger	Nom:Fem+SG
horloger	horloger	Adj:Mas+SG
horloger	horloger	Nom:Mas+SG
horlogerie	horlogerie	Nom:Fem+SG
horlogeries	horlogerie	Nom:Fem+PL
horlogers	horloger	Adj:Mas+PL
horlogers	horloger	Nom:Mas+PL
horloges	horloge	Nom:Fem+PL
hormis	hormis	Pre
hormonale	hormonal	Adj:Fem+SG
hormonales	hormonal	Adj:Fem+PL
hormonal	hormonal	Adj:Mas+SG
hormonaux	hormonal	Adj:Mas+PL
hormone	hormone	Nom:Fem+SG
hormone	hormoner	Ver:IPre+SG+P1:IPre+SG+P3:SPre+SG+P1:SPre+SG+P3:ImPre+SG+P2
hormones	hormone	Nom:Fem+PL
hormones	hormoner	Ver:IPre+SG+P2:SPre+SG+P2
hormonothérapie	hormonothérapie	Nom:Fem+SG
hornblende	hornblende	Nom:Fem+SG
hornier	hornier	Adj:Mas+SG
horodaté	horodaté	Adj:Mas+SG
horodaté	horodater	Ver:PPas+Mas+SG
horodateur	horodateur	Adj:Mas+SG
horodatrice	horodateur	Adj:Fem+SG
horographie	horographie	Nom:Fem+SG
horographique	horographique	Adj:InvGen+SG
horokilométrique	horokilométrique	Adj:InvGen+SG
horométrie	horométrie	Nom:Fem+SG
horométrique	horométrique	Adj:InvGen+SG
horoptère	horoptère	Nom:Mas+SG
horoscope	horoscope	Nom:Mas+SG
horoscopes	horoscope	Nom:Mas+PL
horoscopique	horoscopique	Adj:InvGen+SG
horreur	horreur	Nom:Fem+SG
horreurs	horreur	Nom:Fem+PL
horreurs	horreurs	Nom:Fem+PL
horrible	horrible	Adj:InvGen+SG
horriblement	horriblement	Adv
horribles	horrible	Adj:InvGen+PL
horrifia	horrifier	Ver:IPSim+SG+P3
horrifiaient	horrifier	Ver:IImp+PL+P3
horrifiai	horrifier	Ver:IPSim+SG+P1
horrifiais	horrifier	Ver:IImp+SG+P1:IImp+SG+P2
horrifiait	horrifier	Ver:IImp+SG+P3
horrifiâmes	horrifier	Ver:IPSim+PL+P1
horrifiante	horrifiant	Adj:Fem+SG
horrifiantes	horrifiant	Adj:Fem+PL
horrifiant	horrifiant	Adj:Mas+SG
horrifiant	horrifier	Ver:PPre
horrifiants	horrifiant	Adj:Mas+PL
horrifias	horrifier	Ver:IPSim+SG+P2
horrifiasse	horrifier	Ver:SImp+SG+P1
horrifiassent	horrifier	Ver:SImp+PL+P3
horrifiasses	horrifier	Ver:SImp+SG+P2
horrifiassiez	horrifier	Ver:SImp+PL+P2
horrifiassions	horrifier	Ver:SImp+PL+P1
horrifiâtes	horrifier	Ver:IPSim+PL+P2
horrifiât	horrifier	Ver:SImp+SG+P3
horrifiée	horrifier	Ver:PPas+Fem+SG
horrifiées	horrifier	Ver:PPas+Fem+PL
horrifie	horrifier	Ver:Imp+SG+P2
horrifie	horrifier	Ver:IPre+SG+P1
horrifie	horrifier	Ver:IPre+SG+P3
horrifié	horrifier	Ver:PPas+Mas+SG
horrifie	horrifier	Ver:SPre+SG+P1
horrifie	horrifier	Ver:SPre+SG+P3
horrifient	horrifier	Ver:IPre+PL+P3
horrifient	horrifier	Ver:SPre+PL+P3
horrifiera	horrifier	Ver:IFut+SG+P3
horrifieraient	horrifier	Ver:CPre+PL+P3
horrifierai	horrifier	Ver:IFut+SG+P1
horrifierais	horrifier	Ver:CPre+SG+P1:CPre+SG+P2
horrifierait	horrifier	Ver:CPre+SG+P3
horrifieras	horrifier	Ver:IFut+SG+P2
horrifièrent	horrifier	Ver:IPSim+PL+P3
horrifierez	horrifier	Ver:IFut+PL+P2
horrifier	horrifier	Ver:Inf
horrifieriez	horrifier	Ver:CPre+PL+P2
horrifierions	horrifier	Ver:CPre+PL+P1
horrifierons	horrifier	Ver:IFut+PL+P1
horrifieront	horrifier	Ver:IFut+PL+P3
horrifies	horrifier	Ver:IPre+SG+P2
horrifiés	horrifier	Ver:PPas+Mas+PL
horrifies	horrifier	Ver:SPre+SG+P2
horrifiez	horrifier	Ver:IPre+PL+P2:ImPre+PL+P2
horrifiiez	horrifier	Ver:IImp+PL+P2:SPre+PL+P2
horrifiions	horrifier	Ver:IImp+PL+P1:SPre+PL+P1
horrifions	horrifier	Ver:IPre+PL+P1:ImPre+PL+P1
horrifique	horrifique	Adj:InvGen+SG
horripila	horripiler	Ver:IPSim+SG+P3
horripilaient	horripiler	Ver:IImp+PL+P3
horripilai	horripiler	Ver:IPSim+SG+P1
horripilais	horripiler	Ver:IImp+SG+P1:IImp+SG+P2
horripilait	horripiler	Ver:IImp+SG+P3
horripilâmes	horripiler	Ver:IPSim+PL+P1
horripilante	horripilant	Adj:Fem+SG
horripilantes	horripilant	Adj:Fem+PL
horripilant	horripilant	Adj:Mas+SG
horripilants	horripilant	Adj:Mas+PL
horripilas	horripiler	Ver:IPSim+SG+P2
horripilasse	horripiler	Ver:SImp+SG+P1
horripilassent	horripiler	Ver:SImp+PL+P3
horripilasses	horripiler	Ver:SImp+SG+P2
horripilassiez	horripiler	Ver:SImp+PL+P2
horripilassions	horripiler	Ver:SImp+PL+P1
horripilâtes	horripiler	Ver:IPSim+PL+P2
horripilateur	horripilateur	Adj:Mas+SG
horripilateur	horripilateur	Nom:Mas+SG
horripilât	horripiler	Ver:SImp+SG+P3
horripilation	horripilation	Nom:Fem+SG
horripilations	horripilation	Nom:Fem+PL
horripilée	horripiler	Ver:PPas+Fem+SG
horripilées	horripiler	Ver:PPas+Fem+PL
horripile	horripiler	Ver:IPre+SG+P1:IPre+SG+P3:SPre+SG+P1:SPre+SG+P3:ImPre+SG+P2
horripilé	horripiler	Ver:PPas+Mas+SG
horripilent	horripiler	Ver:IPre+PL+P3:SPre+PL+P3
horripilera	horripiler	Ver:IFut+SG+P3
horripileraient	horripiler	Ver:CPre+PL+P3
horripilerai	horripiler	Ver:IFut+SG+P1
horripilerais	horripiler	Ver:CPre+SG+P1:CPre+SG+P2
horripilerait	horripiler	Ver:CPre+SG+P3
horripileras	horripiler	Ver:IFut+SG+P2
horripilèrent	horripiler	Ver:IPSim+PL+P3
horripilerez	horripiler	Ver:IFut+PL+P2
horripiler	horripiler	Ver:Inf
horripileriez	horripiler	Ver:CPre+PL+P2
horripilerions	horripiler	Ver:CPre+PL+P1
horripilerons	horripiler	Ver:IFut+PL+P1
horripileront	horripiler	Ver:IFut+PL+P3
horripiles	horripiler	Ver:IPre+SG+P2:SPre+SG+P2
horripilés	horripiler	Ver:PPas+Mas+PL
horripilez	horripiler	Ver:IPre+PL+P2:ImPre+PL+P2
horripiliez	horripiler	Ver:IImp+PL+P2:SPre+PL+P2
horripilions	horripiler	Ver:IImp+PL+P1:SPre+PL+P1
horripilons	horripiler	Ver:IPre+PL+P1:ImPre+PL+P1
horsain	horsain	Nom:Mas+SG
horse-guard	horse-guard	Nom:Mas+SG
horse-power	horse-power	Nom:Mas+InvPL
horse-pox	horse-pox	Nom:Mas+InvPL
hors	hors	Adv
hors	hors	Pre
horsin	horsin	Nom:Mas+SG
horst	horst	Nom:Mas+SG
hors-bord	hors-bord	Adj:InvGen+InvPL
hors-bord	hors-bord	Nom:Mas+InvPL
hors-concours	hors-concours	Nom:Mas+InvPL
hors-cote	hors-cote	Adj:InvGen+InvPL
hors-cote	hors-cote	Nom:Mas+InvPL
hors-d'oeuvre	hors-d'oeuvre	Nom:Mas+InvPL
hors-jeu	hors-jeu	Nom:Mas+InvPL
hors-la-loi	hors-la-loi	Nom:Mas+InvPL
hors-ligne	hors-ligne	Nom:Mas+InvPL
hors-piste	hors-piste	Nom:Mas+InvPL
hors-texte	hors-texte	Nom:Mas+InvPL
hortensia	hortensia	Nom:Mas+SG
hortensias	hortensia	Nom:Mas+PL
horticole	horticole	Adj:InvGen+SG
horticoles	horticole	Adj:InvGen+PL
horticulteur	horticulteur	Nom:Mas+SG
horticulteurs	horticulteur	Nom:Mas+PL
horticulture	horticulture	Nom:Fem+SG
hortillonnage	hortillonnage	Nom:Mas+SG
hortillonneur	hortillonneur	Nom:Mas+SG
hosanna	hosanna	Nom:Mas+SG
hosannière	hosannière	Adj:Fem+SG
hospice	hospice	Nom:Mas+SG
hospices	hospice	Nom:Mas+PL
hospitalière	hospitalier	Adj:Fem+SG
hospitalière	hospitalier	Nom:Fem+SG
hospitalières	hospitalier	Adj:Fem+PL
hospitalières	hospitalier	Nom:Fem+PL
hospitalier	hospitalier	Adj:Mas+SG
hospitaliers	hospitalier	Adj:Mas+PL
hospitaliers	hospitalier	Nom:Mas+PL
hospitalisa	hospitaliser	Ver:IPSim+SG+P3
hospitalisaient	hospitaliser	Ver:IImp+PL+P3
hospitalisai	hospitaliser	Ver:IPSim+SG+P1
hospitalisais	hospitaliser	Ver:IImp+SG+P1
hospitalisais	hospitaliser	Ver:IImp+SG+P2
hospitalisait	hospitaliser	Ver:IImp+SG+P3
hospitalisâmes	hospitaliser	Ver:IPSim+PL+P1
hospitalisant	hospitaliser	Ver:PPre
hospitalisas	hospitaliser	Ver:IPSim+SG+P2
hospitalisasse	hospitaliser	Ver:SImp+SG+P1
hospitalisassent	hospitaliser	Ver:SImp+PL+P3
hospitalisasses	hospitaliser	Ver:SImp+SG+P2
hospitalisassiez	hospitaliser	Ver:SImp+PL+P2
hospitalisassions	hospitaliser	Ver:SImp+PL+P1
hospitalisâtes	hospitaliser	Ver:IPSim+PL+P2
hospitalisât	hospitaliser	Ver:SImp+SG+P3
hospitalisation	hospitalisation	Nom:Fem+SG
hospitalisations	hospitalisation	Nom:Fem+PL
hospitalisée	hospitalisé	Nom:Fem+SG
hospitalisée	hospitaliser	Ver:PPas+Fem+SG
hospitalisées	hospitalisé	Nom:Fem+PL
hospitalisées	hospitaliser	Ver:PPas+Fem+PL
hospitalisé	hospitalisé	Nom:Mas+SG
hospitalise	hospitaliser	Ver:IPre+SG+P1:IPre+SG+P3:SPre+SG+P1:SPre+SG+P3:ImPre+SG+P2
hospitalisé	hospitaliser	Ver:PPas+Mas+SG
hospitalisent	hospitaliser	Ver:IPre+PL+P3:SPre+PL+P3
hospitalisera	hospitaliser	Ver:IFut+SG+P3
hospitaliseraient	hospitaliser	Ver:CPre+PL+P3
hospitaliserai	hospitaliser	Ver:IFut+SG+P1
hospitaliserais	hospitaliser	Ver:CPre+SG+P1:CPre+SG+P2
hospitaliserait	hospitaliser	Ver:CPre+SG+P3
hospitaliseras	hospitaliser	Ver:IFut+SG+P2
hospitalisèrent	hospitaliser	Ver:IPSim+PL+P3
hospitaliserez	hospitaliser	Ver:IFut+PL+P2
hospitaliser	hospitaliser	Ver:Inf
hospitaliseriez	hospitaliser	Ver:CPre+PL+P2
hospitaliserions	hospitaliser	Ver:CPre+PL+P1
hospitaliserons	hospitaliser	Ver:IFut+PL+P1
hospitaliseront	hospitaliser	Ver:IFut+PL+P3
hospitalisés	hospitalisé	Nom:Mas+PL
hospitalises	hospitaliser	Ver:IPre+SG+P2:SPre+SG+P2
hospitalisés	hospitaliser	Ver:PPas+Mas+PL
hospitalisez	hospitaliser	Ver:Imp+PL+P2
hospitalisez	hospitaliser	Ver:IPre+PL+P2
hospitalisiez	hospitaliser	Ver:IImp+PL+P2
hospitalisiez	hospitaliser	Ver:SPre+PL+P2
hospitalisions	hospitaliser	Ver:IImp+PL+P1
hospitalisions	hospitaliser	Ver:SPre+PL+P1
hospitalisme	hospitalisme	Nom:Mas+SG
hospitalisons	hospitaliser	Ver:Imp+PL+P1
hospitalisons	hospitaliser	Ver:IPre+PL+P1
hospitalité	hospitalité	Nom:Fem+SG
hospitalo-universitaire	hospitalo-universitaire	Adj:InvGen+SG
hospitalo-universitaires	hospitalo-universitaire	Adj:InvGen+PL
hospodar	hospodar	Nom:Mas+SG
hospodars	hospodar	Nom:Mas+PL
hosteau	hosteau	Nom:Mas+SG
hosteaux	hosteau	Nom:Mas+PL
hostellerie	hostellerie	Nom:Fem+SG
hostelleries	hostellerie	Nom:Fem+PL
hostie	hostie	Nom:Fem+SG
hosties	hostie	Nom:Fem+PL
hostile	hostile	Adj:InvGen+SG
hostilement	hostilement	Adv
hostiles	hostile	Adj:InvGen+PL
hostilité	hostilité	Nom:Fem+SG
hostilités	hostilité	Nom:Fem+PL
hostilités	hostilités	Nom:Fem+PL
hosto	hosto	Nom:Mas+SG
hôte	hôte	Nom:Mas+SG
hôtel	hôtel	Nom:Mas+SG
hôtelière	hôtelier	Adj:Fem+SG
hôtelière	hôtelier	Nom:Fem+SG
hôtelières	hôtelier	Adj:Fem+PL
hôtelières	hôtelier	Nom:Fem+PL
hôtelier	hôtelier	Adj:Mas+SG
hôtelier	hôtelier	Nom:Mas+SG
hôteliers	hôtelier	Adj:Mas+PL
hôteliers	hôtelier	Nom:Mas+PL
hôtellerie	hôtellerie	Nom:Fem+SG
hôtelleries	hôtellerie	Nom:Fem+PL
hôtels	hôtel	Nom:Mas+PL
hôtels-dieu	hôtel-dieu	Nom:Mas+PL
hôtel-dieu	hôtel-dieu	Nom:Mas+SG
hôtes	hôte	Nom:Mas+PL
hôtesse	hôte	Nom:Fem+SG
hôtesse	hôtesse	Nom:Fem+SG
hôtesses	hôte	Nom:Fem+PL
hôtesses	hôtesse	Nom:Fem+PL
hot	hot	Adj:InvGen+SG:InvGen+PL
hot	hot	Nom:Mas+SG
hotta	hotter	Ver:IPSim+SG+P3
hottaient	hotter	Ver:IImp+PL+P3
hottai	hotter	Ver:IPSim+SG+P1
hottais	hotter	Ver:IImp+SG+P1:IImp+SG+P2
hottait	hotter	Ver:IImp+SG+P3
hottâmes	hotter	Ver:IPSim+PL+P1
hottant	hotter	Ver:PPre
hottas	hotter	Ver:IPSim+SG+P2
hottasse	hotter	Ver:SImp+SG+P1
hottassent	hotter	Ver:SImp+PL+P3
hottasses	hotter	Ver:SImp+SG+P2
hottassiez	hotter	Ver:SImp+PL+P2
hottassions	hotter	Ver:SImp+PL+P1
hottâtes	hotter	Ver:IPSim+PL+P2
hottât	hotter	Ver:SImp+SG+P3
hottée	hottée	Nom:Fem+SG
hottée	hotter	Ver:PPas+Fem+SG
hottées	hottée	Nom:Fem+PL
hottées	hotter	Ver:PPas+Fem+PL
hotte	hotte	Nom:Fem+SG
hotte	hotter	Ver:IPre+SG+P1:IPre+SG+P3:SPre+SG+P1:SPre+SG+P3:ImPre+SG+P2
hotté	hotter	Ver:PPas+Mas+SG
hottent	hotter	Ver:IPre+PL+P3:SPre+PL+P3
hottentote	hottentot	Adj:Fem+SG
hottentote	hottentot	Nom:Fem+SG
hottentot	hottentot	Adj:Mas+SG
hottentot	hottentot	Nom:Mas+SG
hottera	hotter	Ver:IFut+SG+P3
hotteraient	hotter	Ver:CPre+PL+P3
hotterai	hotter	Ver:IFut+SG+P1
hotterais	hotter	Ver:CPre+SG+P1:CPre+SG+P2
hotterait	hotter	Ver:CPre+SG+P3
hotteras	hotter	Ver:IFut+SG+P2
hottereau	hottereau	Nom:Mas+SG
hottereaux	hottereau	Nom:Mas+PL
hottèrent	hotter	Ver:IPSim+PL+P3
hotteret	hotteret	Nom:Mas+SG
hotterez	hotter	Ver:IFut+PL+P2
hotter	hotter	Ver:Inf
hotteriez	hotter	Ver:CPre+PL+P2
hotterions	hotter	Ver:CPre+PL+P1
hotterons	hotter	Ver:IFut+PL+P1
hotteront	hotter	Ver:IFut+PL+P3
hottes	hotte	Nom:Fem+PL
hottes	hotter	Ver:IPre+SG+P2:SPre+SG+P2
hotteur	hotteur	Nom:Mas+SG
hottez	hotter	Ver:IPre+PL+P2:ImPre+PL+P2
hottiez	hotter	Ver:IImp+PL+P2:SPre+PL+P2
hottions	hotter	Ver:IImp+PL+P1:SPre+PL+P1
hottons	hotter	Ver:IPre+PL+P1:ImPre+PL+P1
hotu	hotu	Nom:Mas+SG
hot-dog	hot-dog	Nom:Mas+SG
houache	houache	Nom:Fem+SG
houage	houage	Nom:Mas+SG
houages	houage	Nom:Mas+PL
houa	houer	Ver:IPSim+SG+P3
houaiche	houaiche	Nom:Fem+SG
houaient	houer	Ver:IImp+PL+P3
houai	houer	Ver:IPSim+SG+P1
houais	houer	Ver:IImp+SG+P1:IImp+SG+P2
houait	houer	Ver:IImp+SG+P3
houâmes	houer	Ver:IPSim+PL+P1
houant	houer	Ver:PPre
houari	houari	Nom:Mas+SG
houas	houer	Ver:IPSim+SG+P2
houasse	houer	Ver:SImp+SG+P1
houassent	houer	Ver:SImp+PL+P3
houasses	houer	Ver:SImp+SG+P2
houassiez	houer	Ver:SImp+PL+P2
houassions	houer	Ver:SImp+PL+P1
houâtes	houer	Ver:IPSim+PL+P2
houât	houer	Ver:SImp+SG+P3
houblon	houblon	Nom:Mas+SG
houblonnage	houblonnage	Nom:Mas+SG
houblonnages	houblonnage	Nom:Mas+PL
houblonna	houblonner	Ver:IPSim+SG+P3
houblonnaient	houblonner	Ver:IImp+PL+P3
houblonnai	houblonner	Ver:IPSim+SG+P1
houblonnais	houblonner	Ver:IImp+SG+P1:IImp+SG+P2
houblonnait	houblonner	Ver:IImp+SG+P3
houblonnâmes	houblonner	Ver:IPSim+PL+P1
houblonnant	houblonner	Ver:PPre
houblonnas	houblonner	Ver:IPSim+SG+P2
houblonnasse	houblonner	Ver:SImp+SG+P1
houblonnassent	houblonner	Ver:SImp+PL+P3
houblonnasses	houblonner	Ver:SImp+SG+P2
houblonnassiez	houblonner	Ver:SImp+PL+P2
houblonnassions	houblonner	Ver:SImp+PL+P1
houblonnâtes	houblonner	Ver:IPSim+PL+P2
houblonnât	houblonner	Ver:SImp+SG+P3
houblonne	houblonner	Ver:IPre+SG+P1:IPre+SG+P3:SPre+SG+P1:SPre+SG+P3:ImPre+SG+P2
houblonné	houblonner	Ver:PPas+Mas+SG
houblonnent	houblonner	Ver:IPre+PL+P3:SPre+PL+P3
houblonnèrent	houblonner	Ver:IPSim+PL+P3
houblonner	houblonner	Ver:Inf
houblonnes	houblonner	Ver:IPre+SG+P2:SPre+SG+P2
houblonnez	houblonner	Ver:IPre+PL+P2:ImPre+PL+P2
houblonnière	houblonnier	Adj:Fem+SG
houblonnière	houblonnière	Nom:Fem+SG
houblonnière	houblonnier	Nom:Fem+SG
houblonnier	houblonnier	Adj:Mas+SG
houblonnier	houblonnier	Nom:Mas+SG
houblonniez	houblonner	Ver:IImp+PL+P2:SPre+PL+P2
houblonnions	houblonner	Ver:IImp+PL+P1:SPre+PL+P1
houblonnons	houblonner	Ver:IPre+PL+P1:ImPre+PL+P1
houdan	houdan	Nom:Fem+SG
houe	houe	Nom:Fem+SG
houe	houer	Ver:IPre+SG+P1:IPre+SG+P3:SPre+SG+P1:SPre+SG+P3:ImPre+SG+P2
houé	houer	Ver:PPas+Mas+SG
houent	houer	Ver:IPre+PL+P3:SPre+PL+P3
houera	houer	Ver:IFut+SG+P3
houeraient	houer	Ver:CPre+PL+P3
houerai	houer	Ver:IFut+SG+P1
houerais	houer	Ver:CPre+SG+P1:CPre+SG+P2
houerait	houer	Ver:CPre+SG+P3
houeras	houer	Ver:IFut+SG+P2
houèrent	houer	Ver:IPSim+PL+P3
houerez	houer	Ver:IFut+PL+P2
houer	houer	Ver:Inf
houeriez	houer	Ver:CPre+PL+P2
houerions	houer	Ver:CPre+PL+P1
houerons	houer	Ver:IFut+PL+P1
houeront	houer	Ver:IFut+PL+P3
houes	houe	Nom:Fem+PL
houes	houer	Ver:IPre+SG+P2:SPre+SG+P2
houez	houer	Ver:IPre+PL+P2:ImPre+PL+P2
hou	hou	Int
houiez	houer	Ver:IImp+PL+P2:SPre+PL+P2
houille	houille	Nom:Fem+SG
houillère	houiller	Adj:Fem+SG
houillère	houillère	Nom:Fem+SG
houillères	houiller	Adj:Fem+PL
houillères	houillère	Nom:Fem+PL
houiller	houiller	Adj:Mas+SG
houillers	houiller	Adj:Mas+PL
houillers	houiller	Nom:Mas+PL
houilles	houille	Nom:Fem+PL
houions	houer	Ver:IImp+PL+P1:SPre+PL+P1
houka	houka	Nom:Mas+SG
houle	houle	Nom:Fem+SG
houles	houle	Nom:Fem+PL
houlette	houlette	Nom:Fem+SG
houlettes	houlette	Nom:Fem+PL
houleuse	houleux	Adj:Fem+SG
houleuses	houleux	Adj:Fem+PL
houleux	houleux	Adj:Mas+InvPL
houlque	houlque	Nom:Fem+SG
hound	hound	Nom:Mas+SG
houons	houer	Ver:IPre+PL+P1:ImPre+PL+P1
houp	houp	Int
houppa	houpper	Ver:IPSim+SG+P3
houppaient	houpper	Ver:IImp+PL+P3
houppai	houpper	Ver:IPSim+SG+P1
houppais	houpper	Ver:IImp+SG+P1:IImp+SG+P2
houppait	houpper	Ver:IImp+SG+P3
houppâmes	houpper	Ver:IPSim+PL+P1
houppas	houpper	Ver:IPSim+SG+P2
houppasse	houpper	Ver:SImp+SG+P1
houppassent	houpper	Ver:SImp+PL+P3
houppasses	houpper	Ver:SImp+SG+P2
houppassiez	houpper	Ver:SImp+PL+P2
houppassions	houpper	Ver:SImp+PL+P1
houppâtes	houpper	Ver:IPSim+PL+P2
houppât	houpper	Ver:SImp+SG+P3
houppe	houppe	Nom:Fem+SG
houppelande	houppelande	Nom:Fem+SG
houppelandes	houppelande	Nom:Fem+PL
houppent	houpper	Ver:IPre+PL+P3:SPre+PL+P3
houppera	houpper	Ver:IFut+SG+P3
houpperaient	houpper	Ver:CPre+PL+P3
houpperai	houpper	Ver:IFut+SG+P1
houpperais	houpper	Ver:CPre+SG+P1:CPre+SG+P2
houpperait	houpper	Ver:CPre+SG+P3
houpperas	houpper	Ver:IFut+SG+P2
houppèrent	houpper	Ver:IPSim+PL+P3
houpperez	houpper	Ver:IFut+PL+P2
houpper	houpper	Ver:Inf
houpperiez	houpper	Ver:CPre+PL+P2
houpperions	houpper	Ver:CPre+PL+P1
houpperons	houpper	Ver:IFut+PL+P1
houpperont	houpper	Ver:IFut+PL+P3
houppes	houppe	Nom:Fem+PL
houppes	houpper	Ver:IPre+SG+P2:SPre+SG+P2
houppette	houppette	Nom:Fem+SG
houppettes	houppette	Nom:Fem+PL
houppez	houpper	Ver:IPre+PL+P2:ImPre+PL+P2
houppier	houppier	Nom:Mas+SG
houppiers	houppier	Nom:Mas+PL
houppiez	houpper	Ver:IImp+PL+P2:SPre+PL+P2
houppions	houpper	Ver:IImp+PL+P1:SPre+PL+P1
houppons	houpper	Ver:IPre+PL+P1:ImPre+PL+P1
houque	houque	Nom:Fem+SG
hourdage	hourdage	Nom:Mas+SG
hourdages	hourdage	Nom:Mas+PL
hourda	hourder	Ver:IPSim+SG+P3
hourdaient	hourder	Ver:IImp+PL+P3
hourdai	hourder	Ver:IPSim+SG+P1
hourdais	hourder	Ver:IImp+SG+P1:IImp+SG+P2
hourdait	hourder	Ver:IImp+SG+P3
hourdâmes	hourder	Ver:IPSim+PL+P1
hourdant	hourder	Ver:PPre
hourdas	hourder	Ver:IPSim+SG+P2
hourdasse	hourder	Ver:SImp+SG+P1
hourdassent	hourder	Ver:SImp+PL+P3
hourdasses	hourder	Ver:SImp+SG+P2
hourdassiez	hourder	Ver:SImp+PL+P2
hourdassions	hourder	Ver:SImp+PL+P1
hourdâtes	hourder	Ver:IPSim+PL+P2
hourdât	hourder	Ver:SImp+SG+P3
hourde	hourder	Ver:IPre+SG+P1:IPre+SG+P3:SPre+SG+P1:SPre+SG+P3:ImPre+SG+P2
hourdé	hourder	Ver:PPas+Mas+SG
hourdent	hourder	Ver:IPre+PL+P3:SPre+PL+P3
hourdèrent	hourder	Ver:IPSim+PL+P3
hourder	hourder	Ver:Inf
hourdes	hourder	Ver:IPre+SG+P2:SPre+SG+P2
hourdez	hourder	Ver:IPre+PL+P2:ImPre+PL+P2
hourd	hourd	Nom:Mas+SG
hourdiez	hourder	Ver:IImp+PL+P2:SPre+PL+P2
hourdions	hourder	Ver:IImp+PL+P1:SPre+PL+P1
hourdis	hourdir	Ver:PPas+Mas+PL:IPre+SG+P1:IPre+SG+P2:IPSim+SG+P1:IPSim+SG+P2:ImPre+SG+P2
hourdis	hourdis	Nom:Mas+InvPL
hourdons	hourder	Ver:IPre+PL+P1:ImPre+PL+P1
houri	houri	Nom:Fem+SG
houri	houri	Nom:Mas+SG
houris	houri	Nom:Fem+PL
houris	houri	Nom:Mas+PL
hourque	hourque	Nom:Fem+SG
hourra	hourra	Int
hourra	hourra	Nom:Mas+SG
hourras	hourra	Nom:Mas+PL
hourvari	hourvari	Nom:Mas+SG
housard	housard	Nom:Mas+SG
houseau	houseau	Nom:Mas+SG
houseaux	houseau	Nom:Mas+PL
houspilla	houspiller	Ver:IPSim+SG+P3
houspillaient	houspiller	Ver:IImp+PL+P3
houspillai	houspiller	Ver:IPSim+SG+P1
houspillais	houspiller	Ver:IImp+SG+P1:IImp+SG+P2
houspillait	houspiller	Ver:IImp+SG+P3
houspillâmes	houspiller	Ver:IPSim+PL+P1
houspillant	houspiller	Ver:PPre
houspillas	houspiller	Ver:IPSim+SG+P2
houspillasse	houspiller	Ver:SImp+SG+P1
houspillassent	houspiller	Ver:SImp+PL+P3
houspillasses	houspiller	Ver:SImp+SG+P2
houspillassiez	houspiller	Ver:SImp+PL+P2
houspillassions	houspiller	Ver:SImp+PL+P1
houspillâtes	houspiller	Ver:IPSim+PL+P2
houspillât	houspiller	Ver:SImp+SG+P3
houspille	houspiller	Ver:IPre+SG+P1:IPre+SG+P3:SPre+SG+P1:SPre+SG+P3:ImPre+SG+P2
houspillé	houspiller	Ver:PPas+Mas+SG
houspillent	houspiller	Ver:IPre+PL+P3:SPre+PL+P3
houspillèrent	houspiller	Ver:IPSim+PL+P3
houspiller	houspiller	Ver:Inf
houspilles	houspiller	Ver:IPre+SG+P2:SPre+SG+P2
houspilleur	houspilleur	Nom:Mas+SG
houspilleurs	houspilleur	Nom:Mas+PL
houspilleuse	houspilleur	Nom:Fem+SG
houspillez	houspiller	Ver:IPre+PL+P2:ImPre+PL+P2
houspilliez	houspiller	Ver:IImp+PL+P2:SPre+PL+P2
houspillions	houspiller	Ver:IImp+PL+P1:SPre+PL+P1
houspillons	houspiller	Ver:IPre+PL+P1:ImPre+PL+P1
houssa	housser	Ver:IPSim+SG+P3
houssaie	houssaie	Nom:Fem+SG
houssaient	housser	Ver:IImp+PL+P3
houssai	housser	Ver:IPSim+SG+P1
houssais	housser	Ver:IImp+SG+P1:IImp+SG+P2
houssait	housser	Ver:IImp+SG+P3
houssâmes	housser	Ver:IPSim+PL+P1
houssant	housser	Ver:PPre
houssas	housser	Ver:IPSim+SG+P2
houssasse	housser	Ver:SImp+SG+P1
houssassent	housser	Ver:SImp+PL+P3
houssasses	housser	Ver:SImp+SG+P2
houssassiez	housser	Ver:SImp+PL+P2
houssassions	housser	Ver:SImp+PL+P1
houssâtes	housser	Ver:IPSim+PL+P2
houssât	housser	Ver:SImp+SG+P3
houssée	houssée	Nom:Fem+SG
houssée	housser	Ver:PPas+Fem+SG
houssées	houssée	Nom:Fem+PL
houssées	housser	Ver:PPas+Fem+PL
housse	housse	Nom:Fem+SG
housse	housser	Ver:IPre+SG+P1:IPre+SG+P3:SPre+SG+P1:SPre+SG+P3:ImPre+SG+P2
houssé	housser	Ver:PPas+Mas+SG
houssent	housser	Ver:IPre+PL+P3:SPre+PL+P3
houssera	housser	Ver:IFut+SG+P3
housseraient	housser	Ver:CPre+PL+P3
housserai	housser	Ver:IFut+SG+P1
housserais	housser	Ver:CPre+SG+P1:CPre+SG+P2
housserait	housser	Ver:CPre+SG+P3
housseras	housser	Ver:IFut+SG+P2
houssèrent	housser	Ver:IPSim+PL+P3
housserez	housser	Ver:IFut+PL+P2
housser	housser	Ver:Inf
housseriez	housser	Ver:CPre+PL+P2
housserions	housser	Ver:CPre+PL+P1
housserons	housser	Ver:IFut+PL+P1
housseront	housser	Ver:IFut+PL+P3
housses	housse	Nom:Fem+PL
housses	housser	Ver:IPre+SG+P2:SPre+SG+P2
housset	housset	Nom:Mas+SG
houssez	housser	Ver:IPre+PL+P2:ImPre+PL+P2
houssiez	housser	Ver:IImp+PL+P2:SPre+PL+P2
houssina	houssiner	Ver:IPSim+SG+P3
houssinaient	houssiner	Ver:IImp+PL+P3
houssinai	houssiner	Ver:IPSim+SG+P1
houssinais	houssiner	Ver:IImp+SG+P1:IImp+SG+P2
houssinait	houssiner	Ver:IImp+SG+P3
houssinâmes	houssiner	Ver:IPSim+PL+P1
houssinant	houssiner	Ver:PPre
houssinas	houssiner	Ver:IPSim+SG+P2
houssinasse	houssiner	Ver:SImp+SG+P1
houssinassent	houssiner	Ver:SImp+PL+P3
houssinasses	houssiner	Ver:SImp+SG+P2
houssinassiez	houssiner	Ver:SImp+PL+P2
houssinassions	houssiner	Ver:SImp+PL+P1
houssinâtes	houssiner	Ver:IPSim+PL+P2
houssinât	houssiner	Ver:SImp+SG+P3
houssine	houssine	Nom:Fem+SG
houssiné	houssiner	Ver:PPas+Mas+SG
houssinent	houssiner	Ver:IPre+PL+P3:SPre+PL+P3
houssinèrent	houssiner	Ver:IPSim+PL+P3
houssiner	houssiner	Ver:Inf
houssines	houssine	Nom:Fem+PL
houssinez	houssiner	Ver:IPre+PL+P2:ImPre+PL+P2
houssiniez	houssiner	Ver:IImp+PL+P2:SPre+PL+P2
houssinions	houssiner	Ver:IImp+PL+P1:SPre+PL+P1
houssinons	houssiner	Ver:IPre+PL+P1:ImPre+PL+P1
houssions	housser	Ver:IImp+PL+P1:SPre+PL+P1
houssoir	houssoir	Nom:Mas+SG
houssons	housser	Ver:IPre+PL+P1:ImPre+PL+P1
housure	housure	Nom:Fem+SG
houx	houx	Nom:Mas+InvPL
hovercraft	hovercraft	Nom:Mas+SG
hovercrafts	hovercraft	Nom:Mas+PL
hoverport	hoverport	Nom:Mas+SG
hoyau	hoyau	Nom:Mas+SG
hoyaux	hoyau	Nom:Mas+PL
hua	huer	Ver:IPSim+SG+P3
huaient	huer	Ver:IImp+PL+P3
huai	huer	Ver:IPSim+SG+P1
huais	huer	Ver:IImp+SG+P1:IImp+SG+P2
huait	huer	Ver:IImp+SG+P3
huâmes	huer	Ver:IPSim+PL+P1
huant	huant	Adj:Mas+SG
huant	huer	Ver:PPre
huants	huant	Adj:Mas+PL
huard	huard	Nom:Mas+SG
huart	huart	Nom:Mas+SG
huas	huer	Ver:IPSim+SG+P2
huasse	huer	Ver:SImp+SG+P1
huassent	huer	Ver:SImp+PL+P3
huasses	huer	Ver:SImp+SG+P2
huassiez	huer	Ver:SImp+PL+P2
huassions	huer	Ver:SImp+PL+P1
huâtes	huer	Ver:IPSim+PL+P2
huât	huer	Ver:SImp+SG+P3
hublot	hublot	Nom:Mas+SG
hublots	hublot	Nom:Mas+PL
hucha	hucher	Ver:IPSim+SG+P3
huchaient	hucher	Ver:IImp+PL+P3
huchai	hucher	Ver:IPSim+SG+P1
huchais	hucher	Ver:IImp+SG+P1:IImp+SG+P2
huchait	hucher	Ver:IImp+SG+P3
huchâmes	hucher	Ver:IPSim+PL+P1
huchant	hucher	Ver:PPre
huchas	hucher	Ver:IPSim+SG+P2
huchasse	hucher	Ver:SImp+SG+P1
huchassent	hucher	Ver:SImp+PL+P3
huchasses	hucher	Ver:SImp+SG+P2
huchassiez	hucher	Ver:SImp+PL+P2
huchassions	hucher	Ver:SImp+PL+P1
huchâtes	hucher	Ver:IPSim+PL+P2
huchât	hucher	Ver:SImp+SG+P3
huche	huche	Nom:Fem+SG
huche	hucher	Ver:IPre+SG+P1:IPre+SG+P3:SPre+SG+P1:SPre+SG+P3:ImPre+SG+P2
huché	hucher	Ver:PPas+Mas+SG
huchent	hucher	Ver:IPre+PL+P3:SPre+PL+P3
huchera	hucher	Ver:IFut+SG+P3
hucheraient	hucher	Ver:CPre+PL+P3
hucherai	hucher	Ver:IFut+SG+P1
hucherais	hucher	Ver:CPre+SG+P1:CPre+SG+P2
hucherait	hucher	Ver:CPre+SG+P3
hucheras	hucher	Ver:IFut+SG+P2
huchèrent	hucher	Ver:IPSim+PL+P3
hucherez	hucher	Ver:IFut+PL+P2
hucher	hucher	Ver:Inf
hucherie	hucherie	Nom:Fem+SG
hucheriez	hucher	Ver:CPre+PL+P2
hucherions	hucher	Ver:CPre+PL+P1
hucherons	hucher	Ver:IFut+PL+P1
hucheront	hucher	Ver:IFut+PL+P3
huches	huche	Nom:Fem+PL
huches	hucher	Ver:IPre+SG+P2:SPre+SG+P2
huchet	huchet	Nom:Mas+SG
huchez	hucher	Ver:IPre+PL+P2:ImPre+PL+P2
huchiez	hucher	Ver:IImp+PL+P2:SPre+PL+P2
huchions	hucher	Ver:IImp+PL+P1:SPre+PL+P1
huchons	hucher	Ver:IPre+PL+P1:ImPre+PL+P1
huée	huée	Nom:Fem+SG
huée	huer	Ver:PPas+Fem+SG
huées	huée	Nom:Fem+PL
huées	huées	Nom:Fem+PL
huées	huer	Ver:PPas+Fem+PL
hue	hue	Int
hue	huer	Ver:IPre+SG+P1:IPre+SG+P3:SPre+SG+P1:SPre+SG+P3:ImPre+SG+P2
hué	huer	Ver:PPas+Mas+SG
huent	huer	Ver:IPre+PL+P3:SPre+PL+P3
huera	huer	Ver:IFut+SG+P3
hueraient	huer	Ver:CPre+PL+P3
huerai	huer	Ver:IFut+SG+P1
huerais	huer	Ver:CPre+SG+P1:CPre+SG+P2
huerait	huer	Ver:CPre+SG+P3
hueras	huer	Ver:IFut+SG+P2
huèrent	huer	Ver:IPSim+PL+P3
huerez	huer	Ver:IFut+PL+P2
huer	huer	Ver:Inf
hueriez	huer	Ver:CPre+PL+P2
huerions	huer	Ver:CPre+PL+P1
huerons	huer	Ver:IFut+PL+P1
hueront	huer	Ver:IFut+PL+P3
huerta	huerta	Nom:Fem+SG
hues	huer	Ver:IPre+SG+P2:SPre+SG+P2
hués	huer	Ver:PPas+Mas+PL
huez	huer	Ver:IPre+PL+P2:ImPre+PL+P2
hugolien	hugolien	Adj:Mas+SG
huguenote	huguenot	Adj:Fem+SG
huguenote	huguenot	Nom:Fem+SG
huguenot	huguenot	Adj:Mas+SG
huguenot	huguenot	Nom:Mas+SG
huiez	huer	Ver:IImp+PL+P2:SPre+PL+P2
hui	huir	Ver:PPas+Mas+SG
huilage	huilage	Nom:Mas+SG
huilages	huilage	Nom:Mas+PL
huila	huiler	Ver:IPSim+SG+P3
huilaient	huiler	Ver:IImp+PL+P3
huilai	huiler	Ver:IPSim+SG+P1
huilais	huiler	Ver:IImp+SG+P1:IImp+SG+P2
huilait	huiler	Ver:IImp+SG+P3
huilâmes	huiler	Ver:IPSim+PL+P1
huilant	huiler	Ver:PPre
huilas	huiler	Ver:IPSim+SG+P2
huilasse	huiler	Ver:SImp+SG+P1
huilassent	huiler	Ver:SImp+PL+P3
huilasses	huiler	Ver:SImp+SG+P2
huilassiez	huiler	Ver:SImp+PL+P2
huilassions	huiler	Ver:SImp+PL+P1
huilâtes	huiler	Ver:IPSim+PL+P2
huilât	huiler	Ver:SImp+SG+P3
huilée	huiler	Ver:PPas+Fem+SG
huilées	huiler	Ver:PPas+Fem+PL
huile	huile	Nom:Fem+SG
huilé	huiler	Ver:PPas+Mas+SG
huilent	huiler	Ver:IPre+PL+P3:SPre+PL+P3
huilera	huiler	Ver:IFut+SG+P3
huileraient	huiler	Ver:CPre+PL+P3
huilerai	huiler	Ver:IFut+SG+P1
huilerais	huiler	Ver:CPre+SG+P1:CPre+SG+P2
huilerait	huiler	Ver:CPre+SG+P3
huileras	huiler	Ver:IFut+SG+P2
huilèrent	huiler	Ver:IPSim+PL+P3
huilerez	huiler	Ver:IFut+PL+P2
huiler	huiler	Ver:Inf
huilerie	huilerie	Nom:Fem+SG
huileries	huilerie	Nom:Fem+PL
huileriez	huiler	Ver:CPre+PL+P2
huilerions	huiler	Ver:CPre+PL+P1
huilerons	huiler	Ver:IFut+PL+P1
huileront	huiler	Ver:IFut+PL+P3
huiles	huile	Nom:Fem+PL
huilés	huiler	Ver:PPas+Mas+PL
huileuse	huileux	Adj:Fem+SG
huileuses	huileux	Adj:Fem+PL
huileux	huileux	Adj:Mas+InvPL
huilez	huiler	Ver:IPre+PL+P2:ImPre+PL+P2
huilier	huilier	Adj:Mas+SG
huilier	huilier	Nom:Mas+SG
huiliers	huilier	Adj:Mas+PL
huiliers	huilier	Nom:Mas+PL
huiliez	huiler	Ver:IImp+PL+P2:SPre+PL+P2
huilions	huiler	Ver:IImp+PL+P1:SPre+PL+P1
huilons	huiler	Ver:IPre+PL+P1:ImPre+PL+P1
huions	huer	Ver:IImp+PL+P1:SPre+PL+P1
huis	huir	Ver:IPre+SG+P1:IPre+SG+P2:IPSim+SG+P1:IPSim+SG+P2:ImPre+SG+P2
huis	huis	Nom:Mas+InvPL
huisserie	huisserie	Nom:Fem+SG
huisseries	huisserie	Nom:Fem+PL
huissier	huissier	Nom:Mas+SG
huissiers	huissier	Nom:Mas+PL
huitaine	huitaine	Nom:Fem+SG
huitaines	huitaine	Nom:Fem+PL
huitain	huitain	Nom:Mas+SG
huitante	huitante	Det:InvGen+PL
huitarde	huitard	Adj:Fem+SG
huitarde	huitard	Nom:Fem+SG
huitard	huitard	Adj:Mas+SG
huit	huir	Ver:IPre+SG+P3:IPSim+SG+P3
huit	huit	Det:InvGen+PL
huit	huit	Nom:Mas+InvPL
huitième	huitième	Adj:InvGen+SG
huitième	huitième	Nom:Fem+SG
huitième	huitième	Nom:InvGen+SG
huitième	huitième	Nom:Mas+SG
huitièmement	huitièmement	Adv
huitièmes	huitième	Adj:InvGen+PL
huitièmes	huitième	Nom:Fem+PL
huitièmes	huitième	Nom:InvGen+PL
huitièmes	huitième	Nom:Mas+PL
huître	huître	Nom:Fem+SG
huîtres	huître	Nom:Fem+PL
huîtrière	huîtrier	Adj:Fem+SG
huîtrière	huîtrière	Nom:Fem+SG
huîtrière	huîtrier	Nom:Fem+SG
huîtrier	huîtrier	Adj:Mas+SG
huit-reflets	huit-reflets	Nom:Mas+InvPL
hulotte	hulotte	Nom:Fem+SG
hulottes	hulotte	Nom:Fem+PL
hulula	hululer	Ver:IPSim+SG+P3
hululaient	hululer	Ver:IImp+PL+P3
hululai	hululer	Ver:IPSim+SG+P1
hululais	hululer	Ver:IImp+SG+P1:IImp+SG+P2
hululait	hululer	Ver:IImp+SG+P3
hululâmes	hululer	Ver:IPSim+PL+P1
hululant	hululer	Ver:PPre
hululas	hululer	Ver:IPSim+SG+P2
hululasse	hululer	Ver:SImp+SG+P1
hululassent	hululer	Ver:SImp+PL+P3
hululasses	hululer	Ver:SImp+SG+P2
hululassiez	hululer	Ver:SImp+PL+P2
hululassions	hululer	Ver:SImp+PL+P1
hululâtes	hululer	Ver:IPSim+PL+P2
hululât	hululer	Ver:SImp+SG+P3
hulule	hululer	Ver:IPre+SG+P1:IPre+SG+P3:SPre+SG+P1:SPre+SG+P3:ImPre+SG+P2
hululé	hululer	Ver:PPas+Mas+SG
hululement	hululement	Nom:Mas+SG
hululent	hululer	Ver:IPre+PL+P3:SPre+PL+P3
hululèrent	hululer	Ver:IPSim+PL+P3
hululer	hululer	Ver:Inf
hulules	hululer	Ver:IPre+SG+P2:SPre+SG+P2
hululez	hululer	Ver:IPre+PL+P2:ImPre+PL+P2
hululiez	hululer	Ver:IImp+PL+P2:SPre+PL+P2
hululions	hululer	Ver:IImp+PL+P1:SPre+PL+P1
hululons	hululer	Ver:IPre+PL+P1:ImPre+PL+P1
humage	humage	Nom:Mas+SG
humages	humage	Nom:Mas+PL
huma	humer	Ver:IPSim+SG+P3
humaient	humer	Ver:IImp+PL+P3
humai	humer	Ver:IPSim+SG+P1
humaine	humain	Adj:Fem+SG
humainement	humainement	Adv
humaines	humain	Adj:Fem+PL
humain	humain	Adj:Mas+SG
humains	humain	Adj:Mas+PL
humains	humain	Nom:Mas+PL
humains	humains	Nom:Mas+PL
humais	humer	Ver:IImp+SG+P1:IImp+SG+P2
humait	humer	Ver:IImp+SG+P3
humâmes	humer	Ver:IPSim+PL+P1
humanisable	humanisable	Adj:InvGen+SG
humanisa	humaniser	Ver:IPSim+SG+P3
humanisaient	humaniser	Ver:IImp+PL+P3
humanisai	humaniser	Ver:IPSim+SG+P1
humanisais	humaniser	Ver:IImp+SG+P1:IImp+SG+P2
humanisait	humaniser	Ver:IImp+SG+P3
humanisâmes	humaniser	Ver:IPSim+PL+P1
humanisant	humaniser	Ver:PPre
humanisas	humaniser	Ver:IPSim+SG+P2
humanisasse	humaniser	Ver:SImp+SG+P1
humanisassent	humaniser	Ver:SImp+PL+P3
humanisasses	humaniser	Ver:SImp+SG+P2
humanisassiez	humaniser	Ver:SImp+PL+P2
humanisassions	humaniser	Ver:SImp+PL+P1
humanisâtes	humaniser	Ver:IPSim+PL+P2
humanisât	humaniser	Ver:SImp+SG+P3
humanisation	humanisation	Nom:Fem+SG
humanisations	humanisation	Nom:Fem+PL
humanisée	humaniser	Ver:PPas+Fem+SG
humanisées	humaniser	Ver:PPas+Fem+PL
humanise	humaniser	Ver:IPre+SG+P1:IPre+SG+P3:SPre+SG+P1:SPre+SG+P3:ImPre+SG+P2
humanisé	humaniser	Ver:PPas+Mas+SG
humanisent	humaniser	Ver:IPre+PL+P3:SPre+PL+P3
humanisera	humaniser	Ver:IFut+SG+P3
humaniseraient	humaniser	Ver:CPre+PL+P3
humaniserai	humaniser	Ver:IFut+SG+P1
humaniserais	humaniser	Ver:CPre+SG+P1:CPre+SG+P2
humaniserait	humaniser	Ver:CPre+SG+P3
humaniseras	humaniser	Ver:IFut+SG+P2
humanisèrent	humaniser	Ver:IPSim+PL+P3
humaniserez	humaniser	Ver:IFut+PL+P2
humaniser	humaniser	Ver:Inf
humaniseriez	humaniser	Ver:CPre+PL+P2
humaniserions	humaniser	Ver:CPre+PL+P1
humaniserons	humaniser	Ver:IFut+PL+P1
humaniseront	humaniser	Ver:IFut+PL+P3
humanises	humaniser	Ver:IPre+SG+P2:SPre+SG+P2
humanisés	humaniser	Ver:PPas+Mas+PL
humanisez	humaniser	Ver:IPre+PL+P2:ImPre+PL+P2
humanisiez	humaniser	Ver:IImp+PL+P2:SPre+PL+P2
humanisions	humaniser	Ver:IImp+PL+P1:SPre+PL+P1
humanisme	humanisme	Nom:Mas+SG
humanisons	humaniser	Ver:IPre+PL+P1:ImPre+PL+P1
humaniste	humaniste	Adj:InvGen+SG
humaniste	humaniste	Nom:InvGen+SG
humanistes	humaniste	Adj:InvGen+PL
humanistes	humaniste	Nom:InvGen+PL
humanistique	humanistique	Adj:InvGen+SG
humanitaire	humanitaire	Adj:InvGen+SG
humanitaires	humanitaire	Adj:InvGen+PL
humanitarisme	humanitarisme	Nom:Mas+SG
humanitariste	humanitariste	Adj:InvGen+SG
humanité	humanité	Nom:Fem+SG
humanités	humanité	Nom:Fem+PL
humanités	humanités	Nom:Fem+PL
humanoïde	humanoïde	Adj:InvGen+SG
humanoïdes	humanoïde	Adj:InvGen+PL
humant	humer	Ver:PPre
humas	humer	Ver:IPSim+SG+P2
humasse	humer	Ver:SImp+SG+P1
humassent	humer	Ver:SImp+PL+P3
humasses	humer	Ver:SImp+SG+P2
humassiez	humer	Ver:SImp+PL+P2
humassions	humer	Ver:SImp+PL+P1
humâtes	humer	Ver:IPSim+PL+P2
humât	humer	Ver:SImp+SG+P3
humble	humble	Adj:InvGen+SG
humblement	humblement	Adv
humbles	humble	Adj:InvGen+PL
humectage	humectage	Nom:Mas+SG
humectages	humectage	Nom:Mas+PL
humecta	humecter	Ver:IPSim+SG+P3
humectaient	humecter	Ver:IImp+PL+P3
humectai	humecter	Ver:IPSim+SG+P1
humectais	humecter	Ver:IImp+SG+P1:IImp+SG+P2
humectait	humecter	Ver:IImp+SG+P3
humectâmes	humecter	Ver:IPSim+PL+P1
humectant	humectant	Adj:Mas+SG
humectant	humectant	Nom:Mas+SG
humectant	humecter	Ver:PPre
humectas	humecter	Ver:IPSim+SG+P2
humectasse	humecter	Ver:SImp+SG+P1
humectassent	humecter	Ver:SImp+PL+P3
humectasses	humecter	Ver:SImp+SG+P2
humectassiez	humecter	Ver:SImp+PL+P2
humectassions	humecter	Ver:SImp+PL+P1
humectâtes	humecter	Ver:IPSim+PL+P2
humectât	humecter	Ver:SImp+SG+P3
humectée	humecter	Ver:PPas+Fem+SG
humectées	humecter	Ver:PPas+Fem+PL
humecte	humecter	Ver:IPre+SG+P1:IPre+SG+P3:SPre+SG+P1:SPre+SG+P3:ImPre+SG+P2
humecté	humecter	Ver:PPas+Mas+SG
humectent	humecter	Ver:IPre+PL+P3:SPre+PL+P3
humectera	humecter	Ver:IFut+SG+P3
humecteraient	humecter	Ver:CPre+PL+P3
humecterai	humecter	Ver:IFut+SG+P1
humecterais	humecter	Ver:CPre+SG+P1:CPre+SG+P2
humecterait	humecter	Ver:CPre+SG+P3
humecteras	humecter	Ver:IFut+SG+P2
humectèrent	humecter	Ver:IPSim+PL+P3
humecterez	humecter	Ver:IFut+PL+P2
humecter	humecter	Ver:Inf
humecteriez	humecter	Ver:CPre+PL+P2
humecterions	humecter	Ver:CPre+PL+P1
humecterons	humecter	Ver:IFut+PL+P1
humecteront	humecter	Ver:IFut+PL+P3
humectes	humecter	Ver:IPre+SG+P2:SPre+SG+P2
humectés	humecter	Ver:PPas+Mas+PL
humecteur	humecteur	Nom:Mas+SG
humectez	humecter	Ver:IPre+PL+P2:ImPre+PL+P2
humectiez	humecter	Ver:IImp+PL+P2:SPre+PL+P2
humections	humecter	Ver:IImp+PL+P1:SPre+PL+P1
humectons	humecter	Ver:IPre+PL+P1:ImPre+PL+P1
humée	humer	Ver:PPas+Fem+SG
humées	humer	Ver:PPas+Fem+PL
hume	humer	Ver:IPre+SG+P1:IPre+SG+P3:SPre+SG+P1:SPre+SG+P3:ImPre+SG+P2
humé	humer	Ver:PPas+Mas+SG
hument	humer	Ver:IPre+PL+P3:SPre+PL+P3
humera	humer	Ver:IFut+SG+P3
humeraient	humer	Ver:CPre+PL+P3
humerai	humer	Ver:IFut+SG+P1
humerais	humer	Ver:CPre+SG+P1:CPre+SG+P2
humerait	humer	Ver:CPre+SG+P3
humérale	huméral	Adj:Fem+SG
humérales	huméral	Adj:Fem+PL
huméral	huméral	Adj:Mas+SG
humeras	humer	Ver:IFut+SG+P2
huméraux	huméral	Adj:Mas+PL
humèrent	humer	Ver:IPSim+PL+P3
humerez	humer	Ver:IFut+PL+P2
humer	humer	Ver:Inf
humeriez	humer	Ver:CPre+PL+P2
humerions	humer	Ver:CPre+PL+P1
humerons	humer	Ver:IFut+PL+P1
humeront	humer	Ver:IFut+PL+P3
humérus	humérus	Nom:Mas+InvPL
humes	humer	Ver:IPre+SG+P2:SPre+SG+P2
humés	humer	Ver:PPas+Mas+PL
humeur	humeur	Nom:Fem+SG
humeurs	humeur	Nom:Fem+PL
humez	humer	Ver:IPre+PL+P2:ImPre+PL+P2
hum	hum	Int
hum	hum	Nom:Mas+SG
humicole	humicole	Adj:InvGen+SG
humide	humide	Adj:InvGen+SG
humide	humide	Nom:Mas+SG
humides	humide	Adj:InvGen+PL
humidifia	humidifier	Ver:IPSim+SG+P3
humidifiaient	humidifier	Ver:IImp+PL+P3
humidifiai	humidifier	Ver:IPSim+SG+P1
humidifiais	humidifier	Ver:IImp+SG+P1:IImp+SG+P2
humidifiait	humidifier	Ver:IImp+SG+P3
humidifiâmes	humidifier	Ver:IPSim+PL+P1
humidifiant	humidifier	Ver:PPre
humidifias	humidifier	Ver:IPSim+SG+P2
humidifiasse	humidifier	Ver:SImp+SG+P1
humidifiassent	humidifier	Ver:SImp+PL+P3
humidifiasses	humidifier	Ver:SImp+SG+P2
humidifiassiez	humidifier	Ver:SImp+PL+P2
humidifiassions	humidifier	Ver:SImp+PL+P1
humidifiâtes	humidifier	Ver:IPSim+PL+P2
humidifiât	humidifier	Ver:SImp+SG+P3
humidificateur	humidificateur	Nom:Mas+SG
humidificateurs	humidificateur	Nom:Mas+PL
humidification	humidification	Nom:Fem+SG
humidifiée	humidifier	Ver:PPas+Fem+SG
humidifiées	humidifier	Ver:PPas+Fem+PL
humidifie	humidifier	Ver:IPre+SG+P1:IPre+SG+P3:SPre+SG+P1:SPre+SG+P3:ImPre+SG+P2
humidifié	humidifier	Ver:PPas+Mas+SG
humidifient	humidifier	Ver:IPre+PL+P3:SPre+PL+P3
humidifiera	humidifier	Ver:IFut+SG+P3
humidifieraient	humidifier	Ver:CPre+PL+P3
humidifierai	humidifier	Ver:IFut+SG+P1
humidifierais	humidifier	Ver:CPre+SG+P1:CPre+SG+P2
humidifierait	humidifier	Ver:CPre+SG+P3
humidifieras	humidifier	Ver:IFut+SG+P2
humidifièrent	humidifier	Ver:IPSim+PL+P3
humidifierez	humidifier	Ver:IFut+PL+P2
humidifier	humidifier	Ver:Inf
humidifieriez	humidifier	Ver:CPre+PL+P2
humidifierions	humidifier	Ver:CPre+PL+P1
humidifierons	humidifier	Ver:IFut+PL+P1
humidifieront	humidifier	Ver:IFut+PL+P3
humidifies	humidifier	Ver:IPre+SG+P2:SPre+SG+P2
humidifiés	humidifier	Ver:PPas+Mas+PL
humidifiez	humidifier	Ver:IPre+PL+P2:ImPre+PL+P2
humidifiiez	humidifier	Ver:IImp+PL+P2:SPre+PL+P2
humidifiions	humidifier	Ver:IImp+PL+P1:SPre+PL+P1
humidifions	humidifier	Ver:IPre+PL+P1:ImPre+PL+P1
humidimètre	humidimètre	Nom:Mas+SG
humidité	humidité	Nom:Fem+SG
humiez	humer	Ver:IImp+PL+P2:SPre+PL+P2
humifère	humifère	Adj:InvGen+SG
humification	humification	Nom:Fem+SG
humilia	humilier	Ver:IPSim+SG+P3
humiliaient	humilier	Ver:IImp+PL+P3
humiliai	humilier	Ver:IPSim+SG+P1
humiliais	humilier	Ver:IImp+SG+P1:IImp+SG+P2
humiliait	humilier	Ver:IImp+SG+P3
humiliâmes	humilier	Ver:IPSim+PL+P1
humiliante	humiliant	Adj:Fem+SG
humiliantes	humiliant	Adj:Fem+PL
humiliant	humiliant	Adj:Mas+SG
humiliant	humilier	Ver:PPre
humiliants	humiliant	Adj:Mas+PL
humilias	humilier	Ver:IPSim+SG+P2
humiliasse	humilier	Ver:SImp+SG+P1
humiliassent	humilier	Ver:SImp+PL+P3
humiliasses	humilier	Ver:SImp+SG+P2
humiliassiez	humilier	Ver:SImp+PL+P2
humiliassions	humilier	Ver:SImp+PL+P1
humiliâtes	humilier	Ver:IPSim+PL+P2
humiliât	humilier	Ver:SImp+SG+P3
humiliation	humiliation	Nom:Fem+SG
humiliations	humiliation	Nom:Fem+PL
humiliée	humilié	Adj:Fem+SG
humiliée	humilié	Nom:Fem+SG
humiliée	humilier	Ver:PPas+Fem+SG
humiliées	humilié	Adj:Fem+PL
humiliées	humilié	Nom:Fem+PL
humiliées	humilier	Ver:PPas+Fem+PL
humilié	humilié	Adj:Mas+SG
humilié	humilié	Nom:Mas+SG
humilie	humilier	Ver:IPre+SG+P1:IPre+SG+P3:SPre+SG+P1:SPre+SG+P3:ImPre+SG+P2
humilié	humilier	Ver:PPas+Mas+SG
humilient	humilier	Ver:IPre+PL+P3:SPre+PL+P3
humiliera	humilier	Ver:IFut+SG+P3
humilieraient	humilier	Ver:CPre+PL+P3
humilierai	humilier	Ver:IFut+SG+P1
humilierais	humilier	Ver:CPre+SG+P1:CPre+SG+P2
humilierait	humilier	Ver:CPre+SG+P3
humilieras	humilier	Ver:IFut+SG+P2
humilièrent	humilier	Ver:IPSim+PL+P3
humilierez	humilier	Ver:IFut+PL+P2
humilier	humilier	Ver:Inf
humilieriez	humilier	Ver:CPre+PL+P2
humilierions	humilier	Ver:CPre+PL+P1
humilierons	humilier	Ver:IFut+PL+P1
humilieront	humilier	Ver:IFut+PL+P3
humiliés	humilié	Adj:Mas+PL
humiliés	humilié	Nom:Mas+PL
humilies	humilier	Ver:IPre+SG+P2:SPre+SG+P2
humiliés	humilier	Ver:PPas+Mas+PL
humiliez	humilier	Ver:IPre+PL+P2:ImPre+PL+P2
humiliiez	humilier	Ver:IImp+PL+P2:SPre+PL+P2
humiliions	humilier	Ver:IImp+PL+P1:SPre+PL+P1
humilions	humilier	Ver:IPre+PL+P1:ImPre+PL+P1
humilité	humilité	Nom:Fem+SG
humilités	humilité	Nom:Fem+PL
humions	humer	Ver:IImp+PL+P1:SPre+PL+P1
humique	humique	Adj:InvGen+SG
humons	humer	Ver:IPre+PL+P1:ImPre+PL+P1
humorale	humoral	Adj:Fem+SG
humorales	humoral	Adj:Fem+PL
humoral	humoral	Adj:Mas+SG
humoraux	humoral	Adj:Mas+PL
humorisme	humorisme	Nom:Mas+SG
humoriste	humoriste	Adj:InvGen+SG
humoriste	humoriste	Nom:InvGen+SG
humoristes	humoriste	Adj:InvGen+PL
humoristes	humoriste	Nom:InvGen+PL
humoristique	humoristique	Adj:InvGen+SG
humoristiques	humoristique	Adj:InvGen+PL
humour	humour	Nom:Mas+SG
humours	humour	Nom:Mas+PL
humus	humus	Nom:Mas+InvPL
hune	hune	Nom:Fem+SG
hunes	hune	Nom:Fem+PL
hunier	hunier	Nom:Mas+SG
hunnique	hunnique	Adj:InvGen+SG
hunter	hunter	Nom:Mas+SG
huons	huer	Ver:IPre+PL+P1:ImPre+PL+P1
huppée	huppé	Adj:Fem+SG
huppées	huppé	Adj:Fem+PL
huppé	huppé	Adj:Mas+SG
huppe	huppe	Nom:Fem+SG
huppés	huppé	Adj:Mas+PL
huppes	huppe	Nom:Fem+PL
hurdler	hurdler	Nom:InvGen+SG
hure	hure	Nom:Fem+SG
hurla	hurler	Ver:IPSim+SG+P3
hurlaient	hurler	Ver:IImp+PL+P3
hurlai	hurler	Ver:IPSim+SG+P1
hurlais	hurler	Ver:IImp+SG+P1:IImp+SG+P2
hurlait	hurler	Ver:IImp+SG+P3
hurlâmes	hurler	Ver:IPSim+PL+P1
hurlante	hurlant	Adj:Fem+SG
hurlantes	hurlant	Adj:Fem+PL
hurlant	hurlant	Adj:Mas+SG
hurlants	hurlant	Adj:Mas+PL
hurlas	hurler	Ver:IPSim+SG+P2
hurlasse	hurler	Ver:SImp+SG+P1
hurlassent	hurler	Ver:SImp+PL+P3
hurlasses	hurler	Ver:SImp+SG+P2
hurlassiez	hurler	Ver:SImp+PL+P2
hurlassions	hurler	Ver:SImp+PL+P1
hurlâtes	hurler	Ver:IPSim+PL+P2
hurlât	hurler	Ver:SImp+SG+P3
hurlée	hurlée	Nom:Fem+SG
hurlée	hurler	Ver:PPas+Fem+SG
hurlées	hurlée	Nom:Fem+PL
hurlées	hurler	Ver:PPas+Fem+PL
hurle	hurler	Ver:IPre+SG+P1:IPre+SG+P3:SPre+SG+P1:SPre+SG+P3:ImPre+SG+P2
hurlé	hurler	Ver:PPas+Mas+SG
hurlement	hurlement	Nom:Mas+SG
hurlements	hurlement	Nom:Mas+PL
hurlent	hurler	Ver:IPre+PL+P3:SPre+PL+P3
hurlera	hurler	Ver:IFut+SG+P3
hurleraient	hurler	Ver:CPre+PL+P3
hurlerai	hurler	Ver:IFut+SG+P1
hurlerais	hurler	Ver:CPre+SG+P1:CPre+SG+P2
hurlerait	hurler	Ver:CPre+SG+P3
hurleras	hurler	Ver:IFut+SG+P2
hurlèrent	hurler	Ver:IPSim+PL+P3
hurlerez	hurler	Ver:IFut+PL+P2
hurler	hurler	Ver:Inf
hurleriez	hurler	Ver:CPre+PL+P2
hurlerions	hurler	Ver:CPre+PL+P1
hurlerons	hurler	Ver:IFut+PL+P1
hurleront	hurler	Ver:IFut+PL+P3
hurles	hurler	Ver:IPre+SG+P2:SPre+SG+P2
hurlés	hurler	Ver:PPas+Mas+PL
hurleur	hurleur	Adj:Mas+SG
hurleur	hurleur	Nom:Mas+SG
hurleurs	hurleur	Adj:Mas+PL
hurleurs	hurleur	Nom:Mas+PL
hurleuse	hurleur	Adj:Fem+SG
hurleuse	hurleur	Nom:Fem+SG
hurlez	hurler	Ver:IPre+PL+P2:ImPre+PL+P2
hurliez	hurler	Ver:IImp+PL+P2:SPre+PL+P2
hurlions	hurler	Ver:IImp+PL+P1:SPre+PL+P1
hurlons	hurler	Ver:IPre+PL+P1:ImPre+PL+P1
hurluberlu	hurluberlu	Nom:Mas+SG
hurluberlus	hurluberlu	Nom:Mas+PL
huron	huron	Adj:Mas+SG
huron	huron	Nom:Mas+SG
huronien	huronien	Adj:Mas+SG
huronne	huron	Adj:Fem+SG
huronne	huron	Nom:Fem+SG
huronnes	huron	Adj:Fem+PL
huronnes	huron	Nom:Fem+PL
hurons	huron	Adj:Mas+PL
hurons	huron	Nom:Mas+PL
hurrah	hurrah	Int
hurrah	hurrah	Nom:Mas+SG
hurrahs	hurrah	Nom:Mas+PL
hurricane	hurricane	Nom:Mas+SG
hussarde	hussarde	Nom:Fem+SG
hussarde	hussarder	Ver:IPre+SG+P1:IPre+SG+P3:SPre+SG+P1:SPre+SG+P3:ImPre+SG+P2
hussardes	hussarde	Nom:Fem+PL
hussardes	hussarder	Ver:IPre+SG+P2:SPre+SG+P2
hussard	hussard	Nom:Mas+SG
hussards	hussard	Nom:Mas+PL
hussite	hussite	Adj:InvGen+SG
hussite	hussite	Nom:InvGen+SG
hutinet	hutinet	Nom:Mas+SG
hutteau	hutteau	Nom:Mas+SG
hutte	hutte	Nom:Fem+SG
huttes	hutte	Nom:Fem+PL
hyacinthe	hyacinthe	Adj:InvGen+SG:InvGen+PL
hyacinthe	hyacinthe	Nom:Fem+SG
hyacinthe	hyacinthe	Nom:Mas+SG
hyaline	hyalin	Adj:Fem+SG
hyalines	hyalin	Adj:Fem+PL
hyalin	hyalin	Adj:Mas+SG
hyalite	hyalite	Nom:Fem+SG
hyalographie	hyalographie	Nom:Fem+SG
hyaloïde	hyaloïde	Adj:InvGen+SG
hyaloïde	hyaloïde	Nom:Fem+SG
hybrida	hybrider	Ver:IPSim+SG+P3
hybridaient	hybrider	Ver:IImp+PL+P3
hybridai	hybrider	Ver:IPSim+SG+P1
hybridais	hybrider	Ver:IImp+SG+P1:IImp+SG+P2
hybridait	hybrider	Ver:IImp+SG+P3
hybridâmes	hybrider	Ver:IPSim+PL+P1
hybridant	hybrider	Ver:PPre
hybridas	hybrider	Ver:IPSim+SG+P2
hybridasse	hybrider	Ver:SImp+SG+P1
hybridassent	hybrider	Ver:SImp+PL+P3
hybridasses	hybrider	Ver:SImp+SG+P2
hybridassiez	hybrider	Ver:SImp+PL+P2
hybridassions	hybrider	Ver:SImp+PL+P1
hybridâtes	hybrider	Ver:IPSim+PL+P2
hybridât	hybrider	Ver:SImp+SG+P3
hybridation	hybridation	Nom:Fem+SG
hybridations	hybridation	Nom:Fem+PL
hybride	hybride	Adj:InvGen+SG
hybride	hybride	Nom:Mas+SG
hybride	hybrider	Ver:IPre+SG+P1:IPre+SG+P3:SPre+SG+P1:SPre+SG+P3:ImPre+SG+P2
hybridé	hybrider	Ver:PPas+Mas+SG
hybrident	hybrider	Ver:IPre+PL+P3:SPre+PL+P3
hybridera	hybrider	Ver:IFut+SG+P3
hybrideraient	hybrider	Ver:CPre+PL+P3
hybriderai	hybrider	Ver:IFut+SG+P1
hybriderais	hybrider	Ver:CPre+SG+P1:CPre+SG+P2
hybriderait	hybrider	Ver:CPre+SG+P3
hybrideras	hybrider	Ver:IFut+SG+P2
hybridèrent	hybrider	Ver:IPSim+PL+P3
hybriderez	hybrider	Ver:IFut+PL+P2
hybrider	hybrider	Ver:Inf
hybrideriez	hybrider	Ver:CPre+PL+P2
hybriderions	hybrider	Ver:CPre+PL+P1
hybriderons	hybrider	Ver:IFut+PL+P1
hybrideront	hybrider	Ver:IFut+PL+P3
hybrides	hybride	Adj:InvGen+PL
hybrides	hybride	Nom:Mas+PL
hybrides	hybrider	Ver:IPre+SG+P2:SPre+SG+P2
hybridez	hybrider	Ver:IPre+PL+P2:ImPre+PL+P2
hybridiez	hybrider	Ver:IImp+PL+P2:SPre+PL+P2
hybridions	hybrider	Ver:IImp+PL+P1:SPre+PL+P1
hybridisme	hybridisme	Nom:Mas+SG
hybridité	hybridité	Nom:Fem+SG
hybridons	hybrider	Ver:IPre+PL+P1:ImPre+PL+P1
hydarthrose	hydarthrose	Nom:Fem+SG
hydatide	hydatide	Nom:Fem+SG
hydne	hydne	Nom:Mas+SG
hydracide	hydracide	Nom:Mas+SG
hydraire	hydraire	Nom:Mas+SG
hydraires	hydraire	Nom:Mas+PL
hydramnios	hydramnios	Nom:Mas+InvPL
hydrargyrisme	hydrargyrisme	Nom:Mas+SG
hydrastis	hydrastis	Nom:Mas+InvPL
hydratable	hydratable	Adj:InvGen+SG
hydrata	hydrater	Ver:IPSim+SG+P3
hydrataient	hydrater	Ver:IImp+PL+P3
hydratai	hydrater	Ver:IPSim+SG+P1
hydratais	hydrater	Ver:IImp+SG+P1:IImp+SG+P2
hydratait	hydrater	Ver:IImp+SG+P3
hydratâmes	hydrater	Ver:IPSim+PL+P1
hydratante	hydratant	Adj:Fem+SG
hydratantes	hydratant	Adj:Fem+PL
hydratant	hydratant	Adj:Mas+SG
hydratant	hydratant	Nom:Mas+SG
hydratant	hydrater	Ver:PPre
hydratants	hydratant	Adj:Mas+PL
hydratas	hydrater	Ver:IPSim+SG+P2
hydratasse	hydrater	Ver:SImp+SG+P1
hydratassent	hydrater	Ver:SImp+PL+P3
hydratasses	hydrater	Ver:SImp+SG+P2
hydratassiez	hydrater	Ver:SImp+PL+P2
hydratassions	hydrater	Ver:SImp+PL+P1
hydratâtes	hydrater	Ver:IPSim+PL+P2
hydratât	hydrater	Ver:SImp+SG+P3
hydratation	hydratation	Nom:Fem+SG
hydratations	hydratation	Nom:Fem+PL
hydratée	hydrater	Ver:PPas+Fem+SG
hydratées	hydrater	Ver:PPas+Fem+PL
hydrate	hydrate	Nom:Mas+SG
hydrate	hydrater	Ver:IPre+SG+P1:IPre+SG+P3:SPre+SG+P1:SPre+SG+P3:ImPre+SG+P2
hydraté	hydrater	Ver:PPas+Mas+SG
hydratent	hydrater	Ver:IPre+PL+P3:SPre+PL+P3
hydratera	hydrater	Ver:IFut+SG+P3
hydrateraient	hydrater	Ver:CPre+PL+P3
hydraterai	hydrater	Ver:IFut+SG+P1
hydraterais	hydrater	Ver:CPre+SG+P1:CPre+SG+P2
hydraterait	hydrater	Ver:CPre+SG+P3
hydrateras	hydrater	Ver:IFut+SG+P2
hydratèrent	hydrater	Ver:IPSim+PL+P3
hydraterez	hydrater	Ver:IFut+PL+P2
hydrater	hydrater	Ver:Inf
hydrateriez	hydrater	Ver:CPre+PL+P2
hydraterions	hydrater	Ver:CPre+PL+P1
hydraterons	hydrater	Ver:IFut+PL+P1
hydrateront	hydrater	Ver:IFut+PL+P3
hydrates	hydrate	Nom:Mas+PL
hydrates	hydrater	Ver:IPre+SG+P2:SPre+SG+P2
hydratés	hydrater	Ver:PPas+Mas+PL
hydratez	hydrater	Ver:IPre+PL+P2:ImPre+PL+P2
hydratiez	hydrater	Ver:IImp+PL+P2:SPre+PL+P2
hydrations	hydrater	Ver:IImp+PL+P1:SPre+PL+P1
hydratons	hydrater	Ver:IPre+PL+P1:ImPre+PL+P1
hydraule	hydraule	Nom:Fem+SG
hydraulicien	hydraulicien	Adj:Mas+SG
hydraulicien	hydraulicien	Nom:Mas+SG
hydraulique	hydraulique	Adj:InvGen+SG
hydraulique	hydraulique	Nom:Fem+SG
hydrauliques	hydraulique	Adj:InvGen+PL
hydrauliques	hydraulique	Nom:Fem+PL
hydraviation	hydraviation	Nom:Fem+SG
hydravion	hydravion	Nom:Mas+SG
hydravions	hydravion	Nom:Mas+PL
hydrazine	hydrazine	Nom:Fem+SG
hydre	hydre	Nom:Fem+SG
hydrémie	hydrémie	Nom:Fem+SG
hydres	hydre	Nom:Fem+PL
hydrie	hydrie	Nom:Fem+SG
hydrique	hydrique	Adj:InvGen+SG
hydrobase	hydrobase	Nom:Fem+SG
hydrobiologie	hydrobiologie	Nom:Fem+SG
hydrocarbonate	hydrocarbonate	Nom:Mas+SG
hydrocarboné	hydrocarboné	Adj:Mas+SG
hydrocarboné	hydrocarboner	Ver:PPas+Mas+SG
hydrocarbure	hydrocarbure	Nom:Mas+SG
hydrocarbures	hydrocarbure	Nom:Mas+PL
hydrocèle	hydrocèle	Nom:Fem+SG
hydrocéphale	hydrocéphale	Adj:InvGen+SG
hydrocéphale	hydrocéphale	Nom:InvGen+SG
hydrocéphalie	hydrocéphalie	Nom:Fem+SG
hydrocharidacée	hydrocharidacée	Nom:Fem+SG
hydroclasseur	hydroclasseur	Nom:Mas+SG
hydrocoralliaire	hydrocoralliaire	Nom:Mas+SG
hydrocoralliaires	hydrocoralliaire	Nom:Mas+PL
hydrocortisone	hydrocortisone	Nom:Fem+SG
hydrocotyle	hydrocotyle	Nom:Fem+SG
hydrocraquage	hydrocraquage	Nom:Mas+SG
hydrocraqueur	hydrocraqueur	Nom:Mas+SG
hydrocution	hydrocution	Nom:Fem+SG
hydrodésulfuration	hydrodésulfuration	Nom:Fem+SG
hydrodynamique	hydrodynamique	Adj:InvGen+SG
hydrofilicale	hydrofilicale	Nom:Fem+SG
hydrofoil	hydrofoil	Nom:Mas+SG
hydrofoils	hydrofoil	Nom:Mas+PL
hydrofugation	hydrofugation	Nom:Fem+SG
hydrofugations	hydrofugation	Nom:Fem+PL
hydrofugeant	hydrofuger	Ver:PPre
hydrofuge	hydrofuge	Adj:InvGen+SG
hydrofuge	hydrofuge	Nom:Mas+SG
hydrofuge	hydrofuger	Ver:IPre+SG+P1:IPre+SG+P3:SPre+SG+P1:SPre+SG+P3:ImPre+SG+P2
hydrofugé	hydrofuger	Ver:PPas+Mas+SG
hydrofugent	hydrofuger	Ver:IPre+PL+P3:SPre+PL+P3
hydrofugera	hydrofuger	Ver:IFut+SG+P3
hydrofugeraient	hydrofuger	Ver:CPre+PL+P3
hydrofugerai	hydrofuger	Ver:IFut+SG+P1
hydrofugerais	hydrofuger	Ver:CPre+SG+P1:CPre+SG+P2
hydrofugerait	hydrofuger	Ver:CPre+SG+P3
hydrofugeras	hydrofuger	Ver:IFut+SG+P2
hydrofugerez	hydrofuger	Ver:IFut+PL+P2
hydrofuger	hydrofuger	Ver:Inf
hydrofugeriez	hydrofuger	Ver:CPre+PL+P2
hydrofugerions	hydrofuger	Ver:CPre+PL+P1
hydrofugerons	hydrofuger	Ver:IFut+PL+P1
hydrofugeront	hydrofuger	Ver:IFut+PL+P3
hydrofuges	hydrofuge	Adj:InvGen+PL
hydrofuges	hydrofuge	Nom:Mas+PL
hydrofuges	hydrofuger	Ver:IPre+SG+P2:SPre+SG+P2
hydrogénant	hydrogénant	Adj:Mas+SG
hydrogénant	hydrogéner	Ver:PPre
hydrogénation	hydrogénation	Nom:Fem+SG
hydrogénations	hydrogénation	Nom:Fem+PL
hydrogéné	hydrogéné	Adj:Mas+SG
hydrogène	hydrogène	Nom:Mas+SG
hydrogène	hydrogéner	Ver:IPre+SG+P1:IPre+SG+P3:SPre+SG+P1:SPre+SG+P3:ImPre+SG+P2
hydrogènent	hydrogéner	Ver:IPre+PL+P3:SPre+PL+P3
hydrogéner	hydrogéner	Ver:Inf
hydrogènes	hydrogéner	Ver:IPre+SG+P2:SPre+SG+P2
hydrogéologie	hydrogéologie	Nom:Fem+SG
hydroglisseur	hydroglisseur	Nom:Mas+SG
hydroglisseurs	hydroglisseur	Nom:Mas+PL
hydrographie	hydrographie	Nom:Fem+SG
hydrolase	hydrolase	Nom:Fem+SG
hydrolat	hydrolat	Nom:Mas+SG
hydrolé	hydrolé	Nom:Mas+SG
hydrolithe	hydrolithe	Nom:Fem+SG
hydrologie	hydrologie	Nom:Fem+SG
hydrologique	hydrologique	Adj:InvGen+SG
hydrologiste	hydrologiste	Nom:InvGen+SG
hydrologue	hydrologue	Nom:InvGen+SG
hydrolysable	hydrolysable	Adj:InvGen+SG
hydrolysa	hydrolyser	Ver:IPSim+SG+P3
hydrolysaient	hydrolyser	Ver:IImp+PL+P3
hydrolysai	hydrolyser	Ver:IPSim+SG+P1
hydrolysais	hydrolyser	Ver:IImp+SG+P1:IImp+SG+P2
hydrolysait	hydrolyser	Ver:IImp+SG+P3
hydrolysâmes	hydrolyser	Ver:IPSim+PL+P1
hydrolysant	hydrolysant	Adj:Mas+SG
hydrolysant	hydrolyser	Ver:PPre
hydrolysas	hydrolyser	Ver:IPSim+SG+P2
hydrolysasse	hydrolyser	Ver:SImp+SG+P1
hydrolysassent	hydrolyser	Ver:SImp+PL+P3
hydrolysasses	hydrolyser	Ver:SImp+SG+P2
hydrolysassiez	hydrolyser	Ver:SImp+PL+P2
hydrolysassions	hydrolyser	Ver:SImp+PL+P1
hydrolysâtes	hydrolyser	Ver:IPSim+PL+P2
hydrolysât	hydrolyser	Ver:SImp+SG+P3
hydrolyse	hydrolyse	Nom:Fem+SG
hydrolyse	hydrolyser	Ver:IPre+SG+P1:IPre+SG+P3:SPre+SG+P1:SPre+SG+P3:ImPre+SG+P2
hydrolysé	hydrolyser	Ver:PPas+Mas+SG
hydrolysent	hydrolyser	Ver:IPre+PL+P3:SPre+PL+P3
hydrolysera	hydrolyser	Ver:IFut+SG+P3
hydrolyseraient	hydrolyser	Ver:CPre+PL+P3
hydrolyserai	hydrolyser	Ver:IFut+SG+P1
hydrolyserais	hydrolyser	Ver:CPre+SG+P1:CPre+SG+P2
hydrolyserait	hydrolyser	Ver:CPre+SG+P3
hydrolyseras	hydrolyser	Ver:IFut+SG+P2
hydrolysèrent	hydrolyser	Ver:IPSim+PL+P3
hydrolyserez	hydrolyser	Ver:IFut+PL+P2
hydrolyser	hydrolyser	Ver:Inf
hydrolyseriez	hydrolyser	Ver:CPre+PL+P2
hydrolyserions	hydrolyser	Ver:CPre+PL+P1
hydrolyserons	hydrolyser	Ver:IFut+PL+P1
hydrolyseront	hydrolyser	Ver:IFut+PL+P3
hydrolyses	hydrolyse	Nom:Fem+PL
hydrolyses	hydrolyser	Ver:IPre+SG+P2:SPre+SG+P2
hydrolysez	hydrolyser	Ver:IPre+PL+P2:ImPre+PL+P2
hydrolysiez	hydrolyser	Ver:IImp+PL+P2:SPre+PL+P2
hydrolysions	hydrolyser	Ver:IImp+PL+P1:SPre+PL+P1
hydrolysons	hydrolyser	Ver:IPre+PL+P1:ImPre+PL+P1
hydromancie	hydromancie	Nom:Fem+SG
hydromécanique	hydromécanique	Adj:InvGen+SG
hydromel	hydromel	Nom:Mas+SG
hydrométallurgie	hydrométallurgie	Nom:Fem+SG
hydrométéore	hydrométéore	Nom:Mas+SG
hydromètre	hydromètre	Nom:Fem+SG
hydromètre	hydromètre	Nom:Mas+SG
hydrométrie	hydrométrie	Nom:Fem+SG
hydrométrique	hydrométrique	Adj:InvGen+SG
hydrominérale	hydrominéral	Adj:Fem+SG
hydrominérales	hydrominéral	Adj:Fem+PL
hydrominéral	hydrominéral	Adj:Mas+SG
hydrominéralurgie	hydrominéralurgie	Nom:Fem+SG
hydrominéraux	hydrominéral	Adj:Mas+PL
hydronéphrose	hydronéphrose	Nom:Fem+SG
hydronymie	hydronymie	Nom:Fem+SG
hydropéricarde	hydropéricarde	Nom:Mas+SG
hydrophile	hydrophile	Adj:InvGen+SG
hydrophile	hydrophile	Nom:Mas+SG
hydrophiles	hydrophile	Adj:InvGen+PL
hydrophiles	hydrophile	Nom:Mas+PL
hydrophobe	hydrophobe	Adj:InvGen+SG
hydrophobie	hydrophobie	Nom:Fem+SG
hydrophtalmie	hydrophtalmie	Nom:Fem+SG
hydropique	hydropique	Adj:InvGen+SG
hydropique	hydropique	Nom:InvGen+SG
hydropisie	hydropisie	Nom:Fem+SG
hydropneumatique	hydropneumatique	Adj:InvGen+SG
hydroptère	hydroptère	Nom:Mas+SG
hydroquinone	hydroquinone	Nom:Fem+SG
hydrosilicate	hydrosilicate	Nom:Mas+SG
hydrosol	hydrosol	Nom:Mas+SG
hydrosoluble	hydrosoluble	Adj:InvGen+SG
hydrosphère	hydrosphère	Nom:Fem+SG
hydrostatique	hydrostatique	Adj:InvGen+SG
hydrostatique	hydrostatique	Nom:Fem+SG
hydrosulfureux	hydrosulfureux	Adj:Mas+InvPL
hydrotaxie	hydrotaxie	Nom:Fem+SG
hydrothérapie	hydrothérapie	Nom:Fem+SG
hydrothérapique	hydrothérapique	Adj:InvGen+SG
hydroxyde	hydroxyde	Nom:Mas+SG
hydroxylique	hydroxylique	Adj:InvGen+SG
hydrozoaire	hydrozoaire	Nom:Mas+SG
hydrozoaires	hydrozoaire	Nom:Mas+PL
hydro-électricité	hydro-électricité	Nom:Fem+SG
hydro-électrique	hydro-électrique	Adj:InvGen+SG
hydrure	hydrure	Nom:Mas+SG
hyène	hyène	Nom:Fem+SG
hyènes	hyène	Nom:Fem+PL
hygiaphone	hygiaphone	Nom:Mas+SG
hygiène	hygiène	Nom:Fem+SG
hygiénique	hygiénique	Adj:InvGen+SG
hygiéniquement	hygiéniquement	Adv
hygiéniques	hygiénique	Adj:InvGen+PL
hygiéniste	hygiéniste	Nom:InvGen+SG
hygroma	hygroma	Nom:Mas+SG
hygromètre	hygromètre	Nom:Mas+SG
hygrométricité	hygrométricité	Nom:Fem+SG
hygrométrie	hygrométrie	Nom:Fem+SG
hygrométrique	hygrométrique	Adj:InvGen+SG
hygrophile	hygrophile	Adj:InvGen+SG
hygrophobe	hygrophobe	Adj:InvGen+SG
hygrophore	hygrophore	Nom:Mas+SG
hygrophyte	hygrophyte	Nom:Fem+SG
hygroscope	hygroscope	Nom:Mas+SG
hygroscopie	hygroscopie	Nom:Fem+SG
hygroscopique	hygroscopique	Adj:InvGen+SG
hygrostat	hygrostat	Nom:Mas+SG
hylozoïsme	hylozoïsme	Nom:Mas+SG
hyménéal	hyménéal	Adj:Mas+SG
hyménée	hyménée	Nom:Mas+SG
hyménées	hyménée	Nom:Mas+PL
hymen	hymen	Nom:Mas+SG
hyménium	hyménium	Nom:Mas+SG
hyménomycète	hyménomycète	Nom:Mas+SG
hyménoptère	hyménoptère	Adj:InvGen+SG
hyménoptère	hyménoptère	Nom:Mas+SG
hyménoptères	hyménoptère	Adj:InvGen+PL
hyménoptères	hyménoptère	Nom:Mas+PL
hymens	hymen	Nom:Mas+PL
hymnaire	hymnaire	Nom:Mas+SG
hymne	hymne	Nom:Fem+SG
hymne	hymne	Nom:Mas+SG
hymnes	hymne	Nom:Fem+PL
hymnes	hymne	Nom:Mas+PL
hymnique	hymnique	Adj:InvGen+SG
hymnographe	hymnographe	Nom:InvGen+SG
hymnographie	hymnographie	Nom:Fem+SG
hymnologie	hymnologie	Nom:Fem+SG
hyoïde	hyoïde	Adj:InvGen+SG
hyoïdes	hyoïde	Adj:InvGen+PL
hyoïdien	hyoïdien	Adj:Mas+SG
hyoïdienne	hyoïdien	Adj:Fem+SG
hyoïdiennes	hyoïdien	Adj:Fem+PL
hypallage	hypallage	Nom:Fem+SG
hypallages	hypallage	Nom:Fem+PL
hyparque	hyparque	Nom:Mas+SG
hyperacidité	hyperacidité	Nom:Fem+SG
hyperacousie	hyperacousie	Nom:Fem+SG
hyperalgésie	hyperalgésie	Nom:Fem+SG
hyperalgésique	hyperalgésique	Adj:InvGen+SG
hyperalgésique	hyperalgésique	Nom:InvGen+SG
hyperalgie	hyperalgie	Nom:Fem+SG
hyperazotémie	hyperazotémie	Nom:Fem+SG
hyperbare	hyperbare	Adj:InvGen+SG
hyperbate	hyperbate	Nom:Fem+SG
hyperbates	hyperbate	Nom:Fem+PL
hyperbole	hyperbole	Nom:Fem+SG
hyperboles	hyperbole	Nom:Fem+PL
hyperbolique	hyperbolique	Adj:InvGen+SG
hyperboliquement	hyperboliquement	Adv
hyperboliques	hyperbolique	Adj:InvGen+PL
hyperboloïde	hyperboloïde	Nom:Mas+SG
hyperboréen	hyperboréen	Adj:Mas+SG
hyperboréenne	hyperboréen	Adj:Fem+SG
hyperboréennes	hyperboréen	Adj:Fem+PL
hypercalcémie	hypercalcémie	Nom:Fem+SG
hypercapnie	hypercapnie	Nom:Fem+SG
hyperchlorhydrie	hyperchlorhydrie	Nom:Fem+SG
hyperchlorurie	hyperchlorurie	Nom:Fem+SG
hypercholestérolémie	hypercholestérolémie	Nom:Fem+SG
hypercholie	hypercholie	Nom:Fem+SG
hyperchrome	hyperchrome	Adj:InvGen+SG
hyperchromie	hyperchromie	Nom:Fem+SG
hypercoagulabilité	hypercoagulabilité	Nom:Fem+SG
hypercorrect	hypercorrect	Adj:Mas+SG
hypercorticisme	hypercorticisme	Nom:Mas+SG
hypercrinie	hypercrinie	Nom:Fem+SG
hypercritique	hypercritique	Adj:InvGen+SG
hypercritique	hypercritique	Nom:Fem+SG
hypercritique	hypercritique	Nom:InvGen+SG
hyperdulie	hyperdulie	Nom:Fem+SG
hyperémotif	hyperémotif	Adj:Mas+SG
hyperémotif	hyperémotif	Nom:Mas+SG
hyperémotive	hyperémotif	Adj:Fem+SG
hyperémotive	hyperémotif	Nom:Fem+SG
hyperémotivité	hyperémotivité	Nom:Fem+SG
hyperesthésie	hyperesthésie	Nom:Fem+SG
hyperfréquence	hyperfréquence	Nom:Fem+SG
hypergenèse	hypergenèse	Nom:Fem+SG
hypergéométrique	hypergéométrique	Adj:InvGen+SG
hypergéométriques	hypergéométrique	Adj:InvGen+PL
hyperglycémiante	hyperglycémiant	Adj:Fem+SG
hyperglycémiantes	hyperglycémiant	Adj:Fem+PL
hyperglycémiant	hyperglycémiant	Adj:Mas+SG
hyperglycémie	hyperglycémie	Nom:Fem+SG
hypergol	hypergol	Nom:Mas+SG
hyperlipémie	hyperlipémie	Nom:Fem+SG
hyperlipidémie	hyperlipidémie	Nom:Fem+SG
hypermarché	hypermarché	Nom:Mas+SG
hypermarchés	hypermarché	Nom:Mas+PL
hypermètre	hypermètre	Adj:InvGen+SG
hypermétrope	hypermétrope	Adj:InvGen+SG
hypermétrope	hypermétrope	Nom:InvGen+SG
hypermétropes	hypermétrope	Adj:InvGen+PL
hypermétropes	hypermétrope	Nom:InvGen+PL
hypermétropie	hypermétropie	Nom:Fem+SG
hypermnésie	hypermnésie	Nom:Fem+SG
hypernerveuse	hypernerveux	Adj:Fem+SG
hypernerveuse	hypernerveux	Nom:Fem+SG
hypernerveuses	hypernerveux	Adj:Fem+PL
hypernerveuses	hypernerveux	Nom:Fem+PL
hypernerveux	hypernerveux	Adj:Mas+InvPL
hypernerveux	hypernerveux	Nom:Mas+InvPL
hypéron	hypéron	Nom:Mas+SG
hyperplan	hyperplan	Adj:Mas+SG
hyperplan	hyperplan	Nom:Mas+SG
hyperplasie	hyperplasie	Nom:Fem+SG
hyperplasie	hyperplasier	Ver:IPre+SG+P1:IPre+SG+P3:SPre+SG+P1:SPre+SG+P3:ImPre+SG+P2
hyperréalisme	hyperréalisme	Nom:Mas+SG
hyperréaliste	hyperréaliste	Adj:InvGen+SG
hypersécrétion	hypersécrétion	Nom:Fem+SG
hypersensibilité	hypersensibilité	Nom:Fem+SG
hypersensible	hypersensible	Adj:InvGen+SG
hypersensibles	hypersensible	Adj:InvGen+PL
hypersomnie	hypersomnie	Nom:Fem+SG
hypersonique	hypersonique	Adj:InvGen+SG
hyperstatique	hyperstatique	Adj:InvGen+SG
hypersustentateur	hypersustentateur	Adj:Mas+SG
hypersustentation	hypersustentation	Nom:Fem+SG
hypertélie	hypertélie	Nom:Fem+SG
hypertendue	hypertendu	Adj:Fem+SG
hypertendue	hypertendu	Nom:Fem+SG
hypertendues	hypertendu	Adj:Fem+PL
hypertendues	hypertendu	Nom:Fem+PL
hypertendu	hypertendu	Adj:Mas+SG
hypertendus	hypertendu	Adj:Mas+PL
hypertendus	hypertendu	Nom:Mas+PL
hypertension	hypertension	Nom:Fem+SG
hypertensions	hypertension	Nom:Fem+PL
hyperthermie	hyperthermie	Nom:Fem+SG
hyperthyroïdie	hyperthyroïdie	Nom:Fem+SG
hypertonie	hypertonie	Nom:Fem+SG
hypertonique	hypertonique	Adj:InvGen+SG
hypertrophia	hypertrophier	Ver:IPSim+SG+P3
hypertrophiaient	hypertrophier	Ver:IImp+PL+P3
hypertrophiai	hypertrophier	Ver:IPSim+SG+P1
hypertrophiais	hypertrophier	Ver:IImp+SG+P1:IImp+SG+P2
hypertrophiait	hypertrophier	Ver:IImp+SG+P3
hypertrophiâmes	hypertrophier	Ver:IPSim+PL+P1
hypertrophiant	hypertrophier	Ver:PPre
hypertrophiant	hypertrophier	Ver:PPre+Mas+SG
hypertrophias	hypertrophier	Ver:IPSim+SG+P2
hypertrophiasse	hypertrophier	Ver:SImp+SG+P1
hypertrophiassent	hypertrophier	Ver:SImp+PL+P3
hypertrophiasses	hypertrophier	Ver:SImp+SG+P2
hypertrophiassiez	hypertrophier	Ver:SImp+PL+P2
hypertrophiassions	hypertrophier	Ver:SImp+PL+P1
hypertrophiâtes	hypertrophier	Ver:IPSim+PL+P2
hypertrophiât	hypertrophier	Ver:SImp+SG+P3
hypertrophiée	hypertrophié	Adj:Fem+SG
hypertrophiée	hypertrophier	Ver:PPas+Fem+SG
hypertrophiées	hypertrophié	Adj:Fem+PL
hypertrophiées	hypertrophier	Ver:PPas+Fem+PL
hypertrophié	hypertrophié	Adj:Mas+SG
hypertrophie	hypertrophie	Nom:Fem+SG
hypertrophié	hypertrophier	Ver:PPas+Mas+SG
hypertrophient	hypertrophier	Ver:IPre+PL+P3
hypertrophient	hypertrophier	Ver:SPre+PL+P3
hypertrophiera	hypertrophier	Ver:IFut+SG+P3
hypertrophieraient	hypertrophier	Ver:CPre+PL+P3
hypertrophierai	hypertrophier	Ver:IFut+SG+P1
hypertrophierais	hypertrophier	Ver:CPre+SG+P1
hypertrophierais	hypertrophier	Ver:CPre+SG+P2
hypertrophierait	hypertrophier	Ver:CPre+SG+P3
hypertrophieras	hypertrophier	Ver:IFut+SG+P2
hypertrophièrent	hypertrophier	Ver:IPSim+PL+P3
hypertrophierez	hypertrophier	Ver:IFut+PL+P2
hypertrophier	hypertrophier	Ver:Inf
hypertrophieriez	hypertrophier	Ver:CPre+PL+P2
hypertrophierions	hypertrophier	Ver:CPre+PL+P1
hypertrophierons	hypertrophier	Ver:IFut+PL+P1
hypertrophieront	hypertrophier	Ver:IFut+PL+P3
hypertrophiés	hypertrophié	Adj:Mas+PL
hypertrophies	hypertrophie	Nom:Fem+PL
hypertrophies	hypertrophier	Ver:IPre+SG+P2
hypertrophiés	hypertrophier	Ver:PPas+Mas+PL
hypertrophies	hypertrophier	Ver:SPre+SG+P2
hypertrophiez	hypertrophier	Ver:IPre+PL+P2:ImPre+PL+P2
hypertrophiiez	hypertrophier	Ver:IImp+PL+P2:SPre+PL+P2
hypertrophiions	hypertrophier	Ver:IImp+PL+P1:SPre+PL+P1
hypertrophions	hypertrophier	Ver:IPre+PL+P1:ImPre+PL+P1
hypertrophique	hypertrophique	Adj:InvGen+SG
hypertrophiques	hypertrophique	Adj:InvGen+PL
hyp	hypir	Ver:CPre+SG+P1:CPre+SG+P2
hypnose	hypnose	Nom:Fem+SG
hypnotique	hypnotique	Adj:InvGen+SG
hypnotiques	hypnotique	Adj:InvGen+PL
hypnotisa	hypnotiser	Ver:IPSim+SG+P3
hypnotisaient	hypnotiser	Ver:IImp+PL+P3
hypnotisai	hypnotiser	Ver:IPSim+SG+P1
hypnotisais	hypnotiser	Ver:IImp+SG+P1:IImp+SG+P2
hypnotisait	hypnotiser	Ver:IImp+SG+P3
hypnotisâmes	hypnotiser	Ver:IPSim+PL+P1
hypnotisant	hypnotiser	Ver:PPre
hypnotisas	hypnotiser	Ver:IPSim+SG+P2
hypnotisasse	hypnotiser	Ver:SImp+SG+P1
hypnotisassent	hypnotiser	Ver:SImp+PL+P3
hypnotisasses	hypnotiser	Ver:SImp+SG+P2
hypnotisassiez	hypnotiser	Ver:SImp+PL+P2
hypnotisassions	hypnotiser	Ver:SImp+PL+P1
hypnotisâtes	hypnotiser	Ver:IPSim+PL+P2
hypnotisât	hypnotiser	Ver:SImp+SG+P3
hypnotisée	hypnotiser	Ver:PPas+Fem+SG
hypnotisées	hypnotiser	Ver:PPas+Fem+PL
hypnotise	hypnotiser	Ver:IPre+SG+P1:IPre+SG+P3:SPre+SG+P1:SPre+SG+P3:ImPre+SG+P2
hypnotisé	hypnotiser	Ver:PPas+Mas+SG
hypnotisent	hypnotiser	Ver:IPre+PL+P3:SPre+PL+P3
hypnotisera	hypnotiser	Ver:IFut+SG+P3
hypnotiseraient	hypnotiser	Ver:CPre+PL+P3
hypnotiserai	hypnotiser	Ver:IFut+SG+P1
hypnotiserais	hypnotiser	Ver:CPre+SG+P1:CPre+SG+P2
hypnotiserait	hypnotiser	Ver:CPre+SG+P3
hypnotiseras	hypnotiser	Ver:IFut+SG+P2
hypnotisèrent	hypnotiser	Ver:IPSim+PL+P3
hypnotiserez	hypnotiser	Ver:IFut+PL+P2
hypnotiser	hypnotiser	Ver:Inf
hypnotiseriez	hypnotiser	Ver:CPre+PL+P2
hypnotiserions	hypnotiser	Ver:CPre+PL+P1
hypnotiserons	hypnotiser	Ver:IFut+PL+P1
hypnotiseront	hypnotiser	Ver:IFut+PL+P3
hypnotises	hypnotiser	Ver:IPre+SG+P2:SPre+SG+P2
hypnotisés	hypnotiser	Ver:PPas+Mas+PL
hypnotiseur	hypnotiseur	Nom:Mas+SG
hypnotiseurs	hypnotiseur	Nom:Mas+PL
hypnotisez	hypnotiser	Ver:IPre+PL+P2:ImPre+PL+P2
hypnotisiez	hypnotiser	Ver:IImp+PL+P2:SPre+PL+P2
hypnotisions	hypnotiser	Ver:IImp+PL+P1:SPre+PL+P1
hypnotisme	hypnotisme	Nom:Mas+SG
hypnotisons	hypnotiser	Ver:IPre+PL+P1:ImPre+PL+P1
hypnotoxine	hypnotoxine	Nom:Fem+SG
hypoacousie	hypoacousie	Nom:Fem+SG
hypocalorique	hypocalorique	Adj:InvGen+SG
hypocauste	hypocauste	Nom:Mas+SG
hypocentre	hypocentre	Nom:Mas+SG
hypochloreux	hypochloreux	Adj:Mas+InvPL
hypochlorhydrie	hypochlorhydrie	Nom:Fem+SG
hypochlorite	hypochlorite	Nom:Mas+SG
hypochlorites	hypochlorite	Nom:Mas+PL
hypochrome	hypochrome	Adj:InvGen+SG
hypocondre	hypocondre	Adj:InvGen+SG
hypocondre	hypocondre	Nom:InvGen+SG
hypocondre	hypocondre	Nom:Mas+SG
hypocondriaque	hypocondriaque	Adj:InvGen+SG
hypocondriaque	hypocondriaque	Nom:InvGen+SG
hypocondriaques	hypocondriaque	Adj:InvGen+PL
hypocondriaques	hypocondriaque	Nom:InvGen+PL
hypocondrie	hypocondrie	Nom:Fem+SG
hypocoristique	hypocoristique	Adj:InvGen+SG
hypocoristique	hypocoristique	Nom:Mas+SG
hypocras	hypocras	Nom:Mas+InvPL
hypocrisie	hypocrisie	Nom:Fem+SG
hypocrite	hypocrite	Adj:InvGen+SG
hypocritement	hypocritement	Adv
hypocrites	hypocrite	Adj:InvGen+PL
hypocycloïdale	hypocycloïdal	Adj:Fem+SG
hypocycloïde	hypocycloïde	Nom:Fem+SG
hypoderme	hypoderme	Nom:Mas+SG
hypodermique	hypodermique	Adj:InvGen+SG
hypodermiques	hypodermique	Adj:InvGen+PL
hypodermose	hypodermose	Nom:Fem+SG
hypogastre	hypogastre	Nom:Mas+SG
hypogastrique	hypogastrique	Adj:InvGen+SG
hypogée	hypogé	Adj:Fem+SG
hypogée	hypogée	Nom:Mas+SG
hypogées	hypogé	Adj:Fem+PL
hypogées	hypogée	Nom:Mas+PL
hypogé	hypogé	Adj:Mas+SG
hypoglobulie	hypoglobulie	Nom:Fem+SG
hypoglosse	hypoglosse	Adj:InvGen+SG
hypoglycémiant	hypoglycémiant	Adj:Mas+SG
hypoglycémiant	hypoglycémiant	Nom:Mas+SG
hypoglycémie	hypoglycémie	Nom:Fem+SG
hypoglycémies	hypoglycémie	Nom:Fem+PL
hypogyne	hypogyne	Adj:InvGen+SG
hypoïde	hypoïde	Adj:InvGen+SG
hypoleucocytose	hypoleucocytose	Nom:Fem+SG
hypolipémie	hypolipémie	Nom:Fem+SG
hypophysaire	hypophysaire	Adj:InvGen+SG
hypophyse	hypophyse	Nom:Fem+SG
hypophyses	hypophyse	Nom:Fem+PL
hyposécrétion	hyposécrétion	Nom:Fem+SG
hypospadias	hypospadias	Nom:Mas+InvPL
hypostase	hypostase	Nom:Fem+SG
hypostasier	hypostasier	Ver:Inf
hypostatique	hypostatique	Adj:InvGen+SG
hypostyle	hypostyle	Adj:InvGen+SG
hyposulfite	hyposulfite	Nom:Mas+SG
hyposulfureux	hyposulfureux	Adj:Mas+InvPL
hypotendue	hypotendu	Adj:Fem+SG
hypotendue	hypotendu	Nom:Fem+SG
hypotendues	hypotendu	Adj:Fem+PL
hypotendues	hypotendu	Nom:Fem+PL
hypotendu	hypotendu	Adj:Mas+SG
hypotendu	hypotendu	Nom:Mas+SG
hypotendus	hypotendu	Adj:Mas+PL
hypotendus	hypotendu	Nom:Mas+PL
hypotension	hypotension	Nom:Fem+SG
hypoténuse	hypoténuse	Nom:Fem+SG
hypoténuses	hypoténuse	Nom:Fem+PL
hypothalamique	hypothalamique	Adj:InvGen+SG
hypothalamus	hypothalamus	Nom:Mas+InvPL
hypothécable	hypothécable	Adj:InvGen+SG
hypothécables	hypothécable	Adj:InvGen+PL
hypothécaire	hypothécaire	Adj:InvGen+SG
hypothécairement	hypothécairement	Adv
hypothécaires	hypothécaire	Adj:InvGen+PL
hypothénar	hypothénar	Nom:Mas+SG
hypothéqua	hypothéquer	Ver:IPSim+SG+P3
hypothéquaient	hypothéquer	Ver:IImp+PL+P3
hypothéquai	hypothéquer	Ver:IPSim+SG+P1
hypothéquais	hypothéquer	Ver:IImp+SG+P1:IImp+SG+P2
hypothéquait	hypothéquer	Ver:IImp+SG+P3
hypothéquâmes	hypothéquer	Ver:IPSim+PL+P1
hypothéquant	hypothéquer	Ver:PPre
hypothéquas	hypothéquer	Ver:IPSim+SG+P2
hypothéquasse	hypothéquer	Ver:SImp+SG+P1
hypothéquassent	hypothéquer	Ver:SImp+PL+P3
hypothéquasses	hypothéquer	Ver:SImp+SG+P2
hypothéquassiez	hypothéquer	Ver:SImp+PL+P2
hypothéquassions	hypothéquer	Ver:SImp+PL+P1
hypothéquâtes	hypothéquer	Ver:IPSim+PL+P2
hypothéquât	hypothéquer	Ver:SImp+SG+P3
hypothéquée	hypothéquer	Ver:PPas+Fem+SG
hypothéquées	hypothéquer	Ver:PPas+Fem+PL
hypothèque	hypothèque	Nom:Fem+SG
hypothèque	hypothéquer	Ver:IPre+SG+P1:IPre+SG+P3:SPre+SG+P1:SPre+SG+P3:ImPre+SG+P2
hypothéqué	hypothéquer	Ver:PPas+Mas+SG
hypothèquent	hypothéquer	Ver:IPre+PL+P3:SPre+PL+P3
hypothéquera	hypothéquer	Ver:IFut+SG+P3
hypothéqueraient	hypothéquer	Ver:CPre+PL+P3
hypothéquerai	hypothéquer	Ver:IFut+SG+P1
hypothéquerais	hypothéquer	Ver:CPre+SG+P1:CPre+SG+P2
hypothéquerait	hypothéquer	Ver:CPre+SG+P3
hypothéqueras	hypothéquer	Ver:IFut+SG+P2
hypothéquèrent	hypothéquer	Ver:IPSim+PL+P3
hypothéquerez	hypothéquer	Ver:IFut+PL+P2
hypothéquer	hypothéquer	Ver:Inf
hypothéqueriez	hypothéquer	Ver:CPre+PL+P2
hypothéquerions	hypothéquer	Ver:CPre+PL+P1
hypothéquerons	hypothéquer	Ver:IFut+PL+P1
hypothéqueront	hypothéquer	Ver:IFut+PL+P3
hypothèques	hypothèque	Nom:Fem+PL
hypothèques	hypothéquer	Ver:IPre+SG+P2:SPre+SG+P2
hypothéqués	hypothéquer	Ver:PPas+Mas+PL
hypothéquez	hypothéquer	Ver:IPre+PL+P2:ImPre+PL+P2
hypothéquiez	hypothéquer	Ver:IImp+PL+P2:SPre+PL+P2
hypothéquions	hypothéquer	Ver:IImp+PL+P1:SPre+PL+P1
hypothéquons	hypothéquer	Ver:IPre+PL+P1:ImPre+PL+P1
hypothermie	hypothermie	Nom:Fem+SG
hypothèse	hypothèse	Nom:Fem+SG
hypothèses	hypothèse	Nom:Fem+PL
hypothétique	hypothétique	Adj:InvGen+SG
hypothétiquement	hypothétiquement	Adv
hypothétiques	hypothétique	Adj:InvGen+PL
hypothyroïdie	hypothyroïdie	Nom:Fem+SG
hypothyroïdisme	hypothyroïdisme	Nom:Mas+SG
hypotonie	hypotonie	Nom:Fem+SG
hypotonique	hypotonique	Adj:InvGen+SG
hypotonique	hypotonique	Nom:InvGen+SG
hypotrophie	hypotrophie	Nom:Fem+SG
hysope	hysope	Nom:Fem+SG
hystérectomie	hystérectomie	Nom:Fem+SG
hystérie	hystérie	Nom:Fem+SG
hystéries	hystérie	Nom:Fem+PL
hystérique	hystérique	Adj:InvGen+SG
hystérique	hystérique	Nom:InvGen+SG
hystériques	hystérique	Adj:InvGen+PL
hystériques	hystérique	Nom:InvGen+PL
hystérographie	hystérographie	Nom:Fem+SG
ouillent	honnir	Ver:PPre
ouillent	honnir	Ver:PPre+Mas+SG

------------------------- FIN DU FICHIER --------------------------------
